RANK,ELO,LEVEL,ALIAS,STREAK,WINS,LOSSES,RATIO,TOTAL,LAST GAME
1,1717,,Amita,+15,112,17,87%,129,2023/04/15
2,1691,,DexN,+34,133,27,83%,160,2023/04/11
3,1675,,Jibber,+35,71,7,91%,78,2023/04/08
4,1667,,elpern,+5,79,22,78%,101,2023/04/14
5,1654,,Mickey,+2,92,35,72%,127,2023/04/13
6,1652,,Hallelujah,+5,205,34,86%,239,2023/04/17
7,1646,,Charlotte,+15,122,36,77%,158,2023/04/15
8,1646,,[Peanut] Caosak,+21,58,3,95%,61,2023/04/10
9,1638,,Theodosios,+38,53,2,96%,55,2023/04/16
10,1635,,Jesus is My Saviour,+24,61,9,87%,70,2023/04/16
11,1634,,IncaUna,+1,97,16,86%,113,2023/04/16
12,1626,,havoc,+33,72,5,94%,77,2023/04/17
13,1622,,JLODGE,+8,147,33,82%,180,2023/04/17
14,1614,,S205,+9,138,21,87%,159,2023/04/17
15,1612,,vwvc,+26,34,1,97%,35,2023/04/14
16,1612,,Rei,+3,77,10,89%,87,2023/03/31
17,1611,,ciamgyic,+3,245,96,72%,341,2023/04/13
18,1608,,Frontyard man,+10,91,16,85%,107,2023/03/26
19,1604,,DumaisTV,+2,75,18,81%,93,2023/04/07
20,1599,,MinigunSC,+20,126,39,76%,165,2023/04/14
21,1594,,BaByuByu,+14,50,7,88%,57,2023/04/14
22,1590,,Jae,+4,138,40,78%,178,2023/04/18
23,1577,,Nicko,+18,38,3,93%,41,2023/04/10
24,1577,,Jokren,+5,73,10,88%,83,2023/04/15
25,1576,,F3riG,+23,27,1,96%,28,2023/04/08
26,1575,,MajorKusaetNogi,+5,63,12,84%,75,2023/04/08
27,1574,,Vesat Eiwalter,-1,150,38,80%,188,2023/04/13
28,1572,,Orangepest,+4,71,20,78%,91,2023/04/15
29,1572,,xFidde,+27,27,0,100%,27,2023/04/10
30,1570,,The101stAirBorne,+2,70,9,89%,79,2023/04/17
31,1569,,[L2P]BartonPL,+3,64,9,88%,73,2023/04/09
32,1563,,The Angry Dutchman,+3,49,9,84%,58,2023/04/17
33,1545,,﹌夕陽の余溫づ,+1,57,11,84%,68,2023/04/09
34,1537,,Ryan Parsons,+3,90,23,80%,113,2023/04/18
35,1536,,Jesulin,+21,21,0,100%,21,2023/04/11
36,1530,,Siberian,+15,55,11,83%,66,2023/04/16
37,1530,,MIRASSOL_БЕСЧЕСТНЫЙ,+10,127,34,79%,161,2023/04/09
38,1528,,UMirinBrah?,+9,65,14,82%,79,2023/04/12
39,1525,,Backyard man,+16,85,27,76%,112,2023/04/17
40,1525,,FloatingC,+20,83,17,83%,100,2023/04/12
41,1523,,老北京鸡肉卷OldBeijingChickenTwister,+1,84,33,72%,117,2023/04/16
42,1503,,Dumme Katze,+6,42,10,81%,52,2023/04/07
43,1502,,JiuMi,+10,36,6,86%,42,2023/04/08
44,1502,,Rod,+3,116,42,73%,158,2023/04/11
45,1500,,Estocade Gaming YT,+9,21,2,91%,23,2023/03/26
46,1500,,Souless and Heartless Monkey Man,+10,34,5,87%,39,2023/04/09
47,1495,,The Sloth,+8,57,14,80%,71,2023/04/07
48,1487,,Stryker,+6,125,53,70%,178,2023/04/13
49,1486,,Outbalz the moon bunny,+5,112,68,62%,180,2023/04/09
50,1481,,DarkAlric,+2,100,41,71%,141,2023/04/18
51,1479,,night_raven0203,+7,39,5,89%,44,2023/04/15
52,1479,,OMGPOP!,+24,32,4,89%,36,2023/04/08
53,1475,,Isildur,-1,29,5,85%,34,2023/04/08
54,1472,,DIRTY_FISHERMAN,+2,53,14,79%,67,2023/04/12
55,1471,,CptLink( jimmy),+2,52,22,70%,74,2023/04/08
56,1470,,a4039,+11,60,15,80%,75,2023/04/14
57,1469,,IntegralSweeD,+4,63,23,73%,86,2023/04/17
58,1465,,Jade Buddha,+4,64,18,78%,82,2023/04/16
59,1465,,Ra11,+1,30,6,83%,36,2023/04/14
60,1465,,PunisHer1638,+6,40,11,78%,51,2023/04/16
61,1462,,momo4sho,+17,32,4,89%,36,2023/04/15
62,1460,,salmonTA,+16,16,0,100%,16,2023/04/13
63,1459,,rrrr4201,+14,33,2,94%,35,2023/04/17
64,1458,,StephennJF,+1,35,5,88%,40,2023/04/17
65,1457,,odung,+4,63,22,74%,85,2023/04/17
66,1454,,fiadaputa,+20,64,23,74%,87,2023/04/12
67,1453,,TarNationZ,-1,17,1,94%,18,2023/03/23
68,1450,,Hanwoomul,-1,14,1,93%,15,2023/04/17
69,1448,,Deep♂Dark♂Fantasy,+3,61,25,71%,86,2023/04/17
70,1445,,Imbbe,+1,35,10,78%,45,2023/04/15
71,1442,,Luvnest,+2,29,5,85%,34,2023/04/17
72,1442,,今夜薄雾,+8,31,6,84%,37,2023/04/16
73,1442,,Madscientist,+1,35,16,69%,51,2023/04/14
74,1438,,NeuralBooch,+7,120,61,66%,181,2023/04/17
75,1438,,vegetabledoge,+4,54,22,71%,76,2023/04/12
76,1437,,lattouf,+9,29,5,85%,34,2023/04/18
77,1436,,Reakly,+10,193,103,65%,296,2023/04/16
78,1433,,Seth299,+5,111,56,66%,167,2023/04/17
79,1428,,[EPIC]gogy,+5,49,10,83%,59,2023/04/15
80,1419,,BrainSplat | HulkSMASH,+2,13,1,93%,14,2023/04/17
81,1419,,Equuz,+4,18,3,86%,21,2023/04/12
82,1419,,nub,-2,17,5,77%,22,2023/04/15
83,1418,,Happycat,+15,16,1,94%,17,2023/04/17
84,1416,,PanzerGrenadier,+8,38,9,81%,47,2023/04/18
85,1414,,MP_HappyPanther,+5,16,2,89%,18,2023/04/05
86,1412,,Barry Chuckle,+3,87,42,67%,129,2023/04/15
87,1411,,Twitch Yunicone≠≠Pony,+3,59,21,74%,80,2023/04/17
88,1409,,MightyMouseJHM,+1,31,7,82%,38,2023/04/18
89,1408,,Wolfe,+12,57,35,62%,92,2023/04/15
90,1408,,AceHiro,+6,42,14,75%,56,2023/04/04
91,1407,,Boomgoesthedynamite,+4,100,49,67%,149,2023/04/12
92,1405,,EL ZULU,+5,25,6,81%,31,2023/04/16
93,1404,,Brickman,+1,23,6,79%,29,2023/04/16
94,1403,,Zenabauer,+3,27,7,79%,34,2023/04/09
95,1403,,Imperial Dane,+2,27,8,77%,35,2023/04/17
96,1403,,K. Ronaldo,+7,15,2,88%,17,2023/03/21
97,1402,,Snoopa,+2,20,6,77%,26,2023/04/14
98,1402,,Pony by Nature,+8,22,4,85%,26,2023/04/17
99,1399,,Herr Blautier,+2,55,25,69%,80,2023/04/13
100,1397,,T.R. 3nder,+2,19,2,90%,21,2023/04/07
101,1397,,Hybris,+16,28,5,85%,33,2023/03/24
102,1396,,Zyswen,+5,26,7,79%,33,2023/04/07
103,1396,,Mordo47,+10,10,0,100%,10,2023/04/07
104,1395,,Nr03,+5,74,37,67%,111,2023/04/06
105,1392,,Guziol#,+6,40,14,74%,54,2023/04/14
106,1391,,Tiefflieger,+7,27,7,79%,34,2023/03/31
107,1391,,cocco,+1,222,142,61%,364,2023/04/12
108,1389,,WebsterBolek,+1,20,3,87%,23,2023/04/10
109,1389,,ChuaMC,+5,86,50,63%,136,2023/04/14
110,1384,,Assyrian♱,+1,36,12,75%,48,2023/04/18
111,1384,,NoBugJustSkill,-2,65,33,66%,98,2023/04/17
112,1383,,SIMONK,-1,9,1,90%,10,2023/04/15
113,1383,,TheGoodMoose,+3,89,40,69%,129,2023/04/17
114,1382,,McDonald,+10,10,0,100%,10,2023/04/17
115,1381,,Cheezus,+3,45,20,69%,65,2023/03/30
116,1381,,-Cr4nk-,+11,16,1,94%,17,2023/04/10
117,1381,,Farlion,+8,15,2,88%,17,2023/04/17
118,1381,,Pinky```,-1,70,35,67%,105,2023/04/18
119,1380,,Doctor Plague XPress,+1,18,4,82%,22,2023/04/16
120,1380,,阴险恶毒熊主任,+7,51,28,65%,79,2023/04/16
121,1378,,HelpingHans,+6,13,2,87%,15,2023/04/04
122,1378,,LemonMint,+4,22,5,81%,27,2023/04/12
123,1378,,Wayne_Wang,+4,14,2,88%,16,2023/04/17
124,1377,,Punk McThrust,-1,26,7,79%,33,2023/04/13
125,1377,,TheChosen,+7,52,24,68%,76,2023/04/18
126,1374,,SkYisTheLimiT,+3,29,11,73%,40,2023/03/29
127,1373,,Kamikaze Scotsman,+12,39,16,71%,55,2023/04/08
128,1372,,Finndeed,+10,26,6,81%,32,2023/04/07
129,1371,,SOLID MATTIC,+7,79,55,59%,134,2023/03/21
130,1370,,50584sh,+11,79,47,63%,126,2023/04/15
131,1369,,eZZzZ,-2,31,9,78%,40,2023/04/17
132,1369,,RoyalHants,-1,209,103,67%,312,2023/04/17
133,1368,,50ping,+2,30,9,77%,39,2023/04/15
134,1366,,T.R. sidewinder,+8,21,5,81%,26,2023/03/31
135,1365,,Fortune,+4,31,8,79%,39,2023/04/16
136,1365,,oziligath,+1,47,29,62%,76,2023/03/21
137,1364,,FarmerJoe,-1,81,33,71%,114,2023/04/17
138,1363,,folder,+5,150,112,57%,262,2023/04/13
139,1360,,Montaign3,+7,16,3,84%,19,2023/04/15
140,1359,,ohmygod321,-1,38,17,69%,55,2023/04/10
141,1357,,bigfriendlybert,+3,24,7,77%,31,2023/03/24
142,1357,,Vector,+9,36,14,72%,50,2023/04/12
143,1356,,enigmas,+5,10,1,91%,11,2023/03/22
144,1356,,Penetron2000,+10,36,17,68%,53,2023/04/14
145,1356,,sam,+3,20,6,77%,26,2023/03/22
146,1354,,FBI OPEN UP,-1,80,36,69%,116,2023/04/08
147,1354,,[★] Klaus von Reinherz,+19,30,10,75%,40,2023/03/26
148,1353,,Inverse,-1,35,12,74%,47,2023/04/18
149,1350,,vonManstein,-1,85,42,67%,127,2023/04/17
150,1348,,Archangel Michael,-3,58,30,66%,88,2023/04/16
151,1348,,NANAMI,+3,10,2,83%,12,2023/03/23
152,1347,,Evilstealer,+2,68,47,59%,115,2023/03/30
153,1346,,Blysk,+10,10,0,100%,10,2023/03/24
154,1345,,The S.E.X. haver,-2,29,14,67%,43,2023/04/02
155,1342,,Vector,-1,15,4,79%,19,2023/04/12
156,1341,,Commander_Utus,+4,18,5,78%,23,2023/04/14
157,1341,,ocean,+1,81,42,66%,123,2023/04/17
158,1341,,J_Shizlet,+4,24,10,71%,34,2023/04/16
159,1339,,LEBANESE FORSES,+4,24,6,80%,30,2023/03/21
160,1338,,Nostalgia93',+5,21,4,84%,25,2023/04/13
161,1338,,BeeFat,+6,14,3,82%,17,2023/03/29
162,1338,,Imperates,+1,25,8,76%,33,2023/03/31
163,1338,,Jelly Bean,+1,33,14,70%,47,2023/04/17
164,1338,,给我一颗星,-2,25,8,76%,33,2023/04/16
165,1336,,Mr. Bepsi,+4,52,27,66%,79,2023/04/02
166,1336,,MR Dun,-5,56,24,70%,80,2023/03/25
167,1336,,Tassos117,+1,32,14,70%,46,2023/04/06
168,1336,,DanielD,+8,13,1,93%,14,2023/04/16
169,1335,,Johnny 99,+8,31,11,74%,42,2023/04/03
170,1335,,LaFaf,-1,25,10,71%,35,2023/03/23
171,1334,,Madkitty,+3,91,44,67%,135,2023/04/16
172,1334,,OHxYEAHxJNP,+5,27,12,69%,39,2023/04/14
173,1333,,dire,+1,118,72,62%,190,2023/04/18
174,1333,,CoH2 sucks,+2,67,43,61%,110,2023/04/01
175,1333,,CheeseTonkatsu,+1,28,14,67%,42,2023/04/01
176,1331,,°NOSMarkov.-,+7,28,19,60%,47,2023/04/07
177,1331,,Jensen,+2,32,14,70%,46,2023/04/01
178,1331,,LW | MUERTE,+4,9,1,90%,10,2023/03/31
179,1330,,^1Soldat^0James,+1,21,9,70%,30,2023/04/15
180,1329,,Lady Rytsu,+4,100,69,59%,169,2023/03/26
181,1329,,JoseyWales_,-1,54,24,69%,78,2023/04/05
182,1329,,Blue Bear,+7,27,10,73%,37,2023/04/06
183,1329,,IpKaiFung,+10,10,0,100%,10,2023/04/18
184,1329,,Tiltimus Prime,-1,93,53,64%,146,2023/04/15
185,1328,,锅连长,+3,61,34,64%,95,2023/04/11
186,1327,,Brits Unplayable-Give Sniper,+1,88,59,60%,147,2023/04/11
187,1327,,pidzi,+3,20,7,74%,27,2023/04/14
188,1325,,Larry Lobster,+5,35,15,70%,50,2023/04/14
189,1325,,Centurion,+11,11,0,100%,11,2023/04/15
190,1325,,kizlo,-1,27,9,75%,36,2023/04/16
191,1323,,Ryan,+3,42,25,63%,67,2023/03/24
192,1323,,ProxyFox,+2,9,1,90%,10,2023/04/11
193,1322,,Mr. Fahrenheit,+7,22,7,76%,29,2023/03/22
194,1321,,-NSO- Hon3ynuts,+2,10,1,91%,11,2023/03/31
195,1320,,Lingu,+1,14,2,88%,16,2023/04/17
196,1317,,小芙丽娅,+1,28,10,74%,38,2023/04/16
197,1317,,2war,+4,17,3,85%,20,2023/04/09
198,1316,,星奏の女仆,+1,17,7,71%,24,2023/04/17
199,1316,,FK9DD,+7,15,4,79%,19,2023/04/17
200,1316,,Heals,-3,83,61,58%,144,2023/04/17
201,1316,,oki,+6,13,4,76%,17,2023/03/30
202,1315,,sgusgu,+2,146,111,57%,257,2023/04/17
203,1312,,Snake™,-2,44,24,65%,68,2023/04/16
204,1312,,Okeyeg,+3,25,10,71%,35,2023/04/06
205,1312,,Jünker,+8,17,3,85%,20,2023/04/17
206,1312,,Harold H,+1,27,12,69%,39,2023/04/14
207,1312,,TDoggyDogg,+2,18,7,72%,25,2023/04/16
208,1312,,swdertfht,+7,12,3,80%,15,2023/04/14
209,1310,,101st.Airbone,+4,42,20,68%,62,2023/04/17
210,1310,,3imWeckla,-1,48,35,58%,83,2023/04/15
211,1309,,Otter,+4,10,2,83%,12,2023/04/08
212,1307,,Eris,+3,110,78,59%,188,2023/04/03
213,1307,,NoMatterWha,-1,96,56,63%,152,2023/04/16
214,1306,,cohmod,+3,24,9,73%,33,2023/04/17
215,1304,,Luckeeey,-1,44,19,70%,63,2023/04/15
216,1304,,PutPut - AusarTheVile,-1,12,3,80%,15,2023/04/04
217,1304,,DieHard,-1,72,44,62%,116,2023/04/17
218,1304,,Kaduin,+4,79,47,63%,126,2023/04/17
219,1302,,John 14,+8,118,91,56%,209,2023/04/08
220,1301,,DaPopeCOH,+2,22,10,69%,32,2023/04/16
221,1300,,Quadro,+3,19,9,68%,28,2023/03/23
222,1299,,you can count on osttruppen!,+5,12,3,80%,15,2023/04/07
223,1299,,Enemy,-1,17,6,74%,23,2023/04/11
224,1299,,turkey cat,+1,21,7,75%,28,2023/04/14
225,1298,,SMOKO,-1,9,1,90%,10,2023/04/14
226,1298,,Quack,+7,15,4,79%,19,2023/04/16
227,1296,,Enterprise Ω,-1,21,9,70%,30,2023/04/17
228,1296,,.Hesko.,+3,80,51,61%,131,2023/04/17
229,1296,,Slyzor,+1,58,32,64%,90,2023/04/17
230,1295,,loleg,-1,9,1,90%,10,2023/04/01
231,1295,,nonononononononono,+5,10,2,83%,12,2023/04/15
232,1294,,xiaomo,+1,11,3,79%,14,2023/03/22
233,1294,,Grounded_Bagel,+1,62,39,61%,101,2023/04/16
234,1294,,Kyeon-woo,+6,16,6,73%,22,2023/04/01
235,1294,,Empa,+1,38,17,69%,55,2023/04/15
236,1293,,Goggzy,-1,28,13,68%,41,2023/04/17
237,1293,,Bames Nond Having A Stronk,-1,82,43,66%,125,2023/04/16
238,1292,,Rechter Winkel,+2,35,12,74%,47,2023/04/17
239,1292,,Bréad Cønnøisséur,-1,44,21,68%,65,2023/04/07
240,1292,,VitaminP,+4,9,2,82%,11,2023/04/16
241,1291,,Wuppie,+2,28,15,65%,43,2023/04/16
242,1291,,포스트정윤종,+7,14,5,74%,19,2023/04/05
243,1291,,Born to Coom,-1,26,13,67%,39,2023/04/17
244,1291,,Fuzzy Panda,+4,18,7,72%,25,2023/04/17
245,1290,,SexPistole,-1,16,6,73%,22,2023/04/15
246,1290,,eMBeLeS,-1,16,6,73%,22,2023/04/16
247,1290,,Fernando87ca,+5,68,44,61%,112,2023/04/14
248,1290,,DOGGI,+2,16,5,76%,21,2023/04/07
249,1288,,Rasler63,+3,14,5,74%,19,2023/04/14
250,1287,,Chad Kensington,-2,14,5,74%,19,2023/04/06
251,1287,,a hell on earth,+3,22,8,73%,30,2023/04/16
252,1287,,Shockz,+4,58,35,62%,93,2023/04/17
253,1286,,Gomi,-1,8,2,80%,10,2023/04/08
254,1286,,Ooged,-1,120,95,56%,215,2023/04/16
255,1285,,nVy,+3,18,8,69%,26,2023/04/06
256,1285,,wolf_tank,-1,25,14,64%,39,2023/03/28
257,1285,,Sunny,+1,11,4,73%,15,2023/04/12
258,1284,,tightrope,+1,25,10,71%,35,2023/04/10
259,1284,,piper dawn,+2,10,3,77%,13,2023/04/01
260,1284,,Lethal,+3,31,14,69%,45,2023/04/15
261,1284,,McBain,-1,13,4,76%,17,2023/04/14
262,1284,,Jeiseun,+4,36,21,63%,57,2023/04/03
263,1284,,BALCK_9,-1,32,20,62%,52,2023/04/16
264,1283,,himynameisho,+3,25,12,68%,37,2023/04/16
265,1282,,Ironfist,+10,55,32,63%,87,2023/04/12
266,1282,,zombi,+1,27,10,73%,37,2023/03/21
267,1281,,Sokay,+1,12,5,71%,17,2023/03/26
268,1281,,normad,+6,22,9,71%,31,2023/04/16
269,1281,,Logys P,+2,13,4,76%,17,2023/04/13
270,1280,,Simplify,-1,28,13,68%,41,2023/04/03
271,1280,,Chairman Pan,+1,28,15,65%,43,2023/04/17
272,1280,,Dezman,+7,19,8,70%,27,2023/04/05
273,1279,,juan.aldava,+6,12,5,71%,17,2023/03/26
274,1279,,TankinatorXD,+2,20,10,67%,30,2023/04/16
275,1278,,Nation,+2,13,4,76%,17,2023/04/12
276,1277,,akutoku,-2,27,14,66%,41,2023/04/06
277,1277,,Dunkerque,+2,34,22,61%,56,2023/04/15
278,1276,,BeerGrills,+2,15,5,75%,20,2023/04/16
279,1275,,Bulars,+7,34,22,61%,56,2023/03/26
280,1275,,Uncle Moist,+2,46,25,65%,71,2023/03/30
281,1275,,Free Stasiu,+3,12,3,80%,15,2023/04/07
282,1273,,Dusty,+1,13,4,76%,17,2023/03/28
283,1273,,AoE rage,+2,15,6,71%,21,2023/03/21
284,1273,,KyrreLubiWodę,+2,12,5,71%,17,2023/04/02
285,1272,,AYIK 01,-1,10,3,77%,13,2023/04/11
286,1272,,Wasack,+1,9,3,75%,12,2023/04/16
287,1272,,GOTE,+5,61,42,59%,103,2023/04/04
288,1271,,zhuk0v,+1,50,27,65%,77,2023/04/16
289,1271,,ъסּסּⁿ»Stoffa,-1,48,30,62%,78,2023/04/11
290,1271,,RyuJou,+3,9,3,75%,12,2023/04/01
291,1270,,cat tank,+3,10,2,83%,12,2023/04/13
292,1268,,Euan,-1,95,64,60%,159,2023/04/16
293,1267,,Lelano,-1,10,3,77%,13,2023/04/09
294,1267,,Gutsee,-2,31,15,67%,46,2023/04/08
295,1266,,Poodle,+4,12,3,80%,15,2023/04/16
296,1266,,AHungryPigeon,+2,49,32,60%,81,2023/04/10
297,1265,,Altrersyr,+2,23,17,58%,40,2023/04/05
298,1265,,Jackatm,+3,19,9,68%,28,2023/04/12
299,1265,,Razer,+7,17,5,77%,22,2023/04/06
300,1265,,DiddlyHole,+2,14,6,70%,20,2023/04/15
301,1265,,Bundy ♥,+9,40,18,69%,58,2023/04/15
302,1265,,Elisabeth Eugenie,-2,51,28,65%,79,2023/04/17
303,1264,,wardog,+3,67,45,60%,112,2023/04/02
304,1264,,Gmoney,-1,14,4,78%,18,2023/04/14
305,1263,,Vector,+7,9,1,90%,10,2023/04/17
306,1263,,Caesar,-2,9,5,64%,14,2023/04/14
307,1263,,我不會說中文,+4,10,2,83%,12,2023/03/30
308,1262,,Vaits,-1,14,7,67%,21,2023/04/10
309,1262,,GluteusMaximus,+1,27,13,68%,40,2023/04/13
310,1262,,BusinessBryce,+1,28,14,67%,42,2023/04/13
311,1258,,JackTW The VTUBER,+3,19,9,68%,28,2023/04/08
312,1257,,Otvor,-1,34,17,67%,51,2023/04/14
313,1257,,69apm,+5,9,1,90%,10,2023/04/13
314,1257,,Xandr27,+2,12,4,75%,16,2023/04/09
315,1257,,realeh,-1,11,3,79%,14,2023/03/23
316,1256,,TowerNumberNine,+5,32,17,65%,49,2023/04/16
317,1256,,Cular13,+1,32,19,63%,51,2023/04/16
318,1254,,crazyromanian,+2,23,12,66%,35,2023/03/26
319,1254,,HI,-2,37,19,66%,56,2023/04/17
320,1253,,DD響,+4,9,2,82%,11,2023/04/12
321,1253,,Dromaeda,+2,38,20,66%,58,2023/04/06
322,1253,,潮去，潮来,-2,19,9,68%,28,2023/03/22
323,1252,,JustLemon,-1,17,7,71%,24,2023/04/01
324,1252,,Franz,+10,19,8,70%,27,2023/04/03
325,1252,,Trademark,+2,8,2,80%,10,2023/04/12
326,1251,,够得到的钟摆,+3,138,112,55%,250,2023/04/17
327,1251,,NaseMabi,-1,21,10,68%,31,2023/03/26
328,1250,,Spades68,+6,10,3,77%,13,2023/04/17
329,1250,,aSIISymbiosis,+4,9,2,82%,11,2023/04/12
330,1250,,~SB 真多~,+4,15,6,71%,21,2023/04/14
331,1250,,Rafapesc,-1,31,15,67%,46,2023/04/17
332,1250,,DeFro,+3,10,2,83%,12,2023/04/17
333,1249,,Dandru,-2,10,3,77%,13,2023/03/22
334,1249,,Sujy,+3,11,5,69%,16,2023/04/07
335,1248,,Le rat Madan,-1,21,10,68%,31,2023/04/14
336,1248,,OnCe_Ov3R,-3,41,26,61%,67,2023/04/11
337,1247,,Le Negev,+3,11,4,73%,15,2023/03/28
338,1247,,KURT_,+3,86,61,59%,147,2023/04/09
339,1247,,hireling,-1,23,17,58%,40,2023/04/17
340,1247,,Parasite,+3,19,8,70%,27,2023/04/15
341,1247,,Zijiren,+2,57,36,61%,93,2023/04/17
342,1246,,GenObi,-1,38,24,61%,62,2023/04/14
343,1246,,Gus Fring,+1,19,9,68%,28,2023/04/12
344,1245,,Herodad,-6,35,22,61%,57,2023/04/01
345,1245,,Sraczka,+1,17,6,74%,23,2023/03/27
346,1245,,Birdy,+5,9,2,82%,11,2023/04/16
347,1245,,Studano,-1,40,26,61%,66,2023/04/08
348,1244,,Kraut,+2,16,9,64%,25,2023/04/11
349,1244,,403671774,+1,56,41,58%,97,2023/04/16
350,1244,,Riftwalker,+4,10,4,71%,14,2023/04/02
351,1244,,Jimbob2121,+1,17,7,71%,24,2023/04/10
352,1242,,Togep,+1,14,5,74%,19,2023/04/06
353,1242,,KC,-1,35,21,63%,56,2023/04/02
354,1242,,AdLibitum003,+2,13,7,65%,20,2023/04/05
355,1242,,Kannamix,+2,53,36,60%,89,2023/04/17
356,1241,,VulcanHDGaming,+1,23,11,68%,34,2023/04/07
357,1241,,bog,+5,41,18,69%,59,2023/04/06
358,1241,,[Meow]MeowTiTi(◓Д◒)✄,+3,37,21,64%,58,2023/03/31
359,1241,,DizzyWaters,+8,20,6,77%,26,2023/04/01
360,1241,,BurdenedWarrior,-1,9,2,82%,11,2023/04/08
361,1241,,CrystalManck,-2,41,26,61%,67,2023/04/17
362,1240,,karamo6,-2,43,23,65%,66,2023/04/15
363,1239,,SturmTigerGoat,+2,18,8,69%,26,2023/03/22
364,1239,,WARWOLFMELF,-2,56,38,60%,94,2023/04/01
365,1238,,CupcakeOfDeath,+1,14,6,70%,20,2023/04/11
366,1238,,Alex Deko,-1,26,15,63%,41,2023/03/26
367,1238,,TwistedTootsy,+1,15,6,71%,21,2023/04/15
368,1238,,asd 546,+8,17,6,74%,23,2023/03/31
369,1238,,SHVAKS,-1,26,15,63%,41,2023/04/04
370,1238,,Roland le Fartere,+3,36,26,58%,62,2023/04/16
371,1237,,[TB] Pvt. Mike,+3,21,15,58%,36,2023/03/23
372,1237,,Tequila Sunset,-3,39,22,64%,61,2023/04/04
373,1237,,FuzZiioN,-2,22,12,65%,34,2023/04/02
374,1236,,Chaos,+2,21,14,60%,35,2023/03/21
375,1235,,Vitzy J,+1,67,48,58%,115,2023/04/16
376,1234,,美味鸡蛋灌饼,+2,14,4,78%,18,2023/04/05
377,1234,,Lanfeust,+1,23,11,68%,34,2023/04/15
378,1234,,Maxi,-1,19,9,68%,28,2023/04/16
379,1234,,Crazy bee,+1,7,3,70%,10,2023/04/04
380,1234,,Waltzing Matilda,+2,63,42,60%,105,2023/04/17
381,1233,,Kleppon,+1,13,4,76%,17,2023/04/02
382,1233,,Яма со мной,+3,19,10,66%,29,2023/03/23
383,1233,,Lifer,+6,16,6,73%,22,2023/04/16
384,1232,,2nd Lt. Wilson [Ranger],+3,20,13,61%,33,2023/04/09
385,1231,,chilipopper,+1,10,4,71%,14,2023/04/09
386,1231,,ZRL454,+10,17,6,74%,23,2023/04/16
387,1231,,MrSir,+2,72,54,57%,126,2023/04/14
388,1230,,BloodSpark,+6,10,2,83%,12,2023/03/23
389,1230,,Bucho Burns,+9,20,8,71%,28,2023/03/25
390,1230,,Iron_Sarge69,+2,29,16,64%,45,2023/04/15
391,1229,,Halophile,+5,31,14,69%,45,2023/04/15
392,1228,,Noob Nath,-1,47,32,59%,79,2023/04/18
393,1228,,Auxiliary Priest,+6,21,11,66%,32,2023/04/06
394,1227,,Sticket,+2,14,6,70%,20,2023/03/31
395,1227,,[MF] YourTherapist,-1,51,34,60%,85,2023/04/10
396,1227,,Peacemaker,-2,23,13,64%,36,2023/04/14
397,1227,,Jsizzle,-1,31,19,62%,50,2023/04/15
398,1226,,Pwnbot,+5,10,3,77%,13,2023/04/02
399,1226,,Attitude Adjuster,+2,35,16,69%,51,2023/04/01
400,1225,,Fredboy3000,+1,15,9,63%,24,2023/04/08
401,1225,,Reaper,-2,9,2,82%,11,2023/04/11
402,1225,,[DPRK]DoGGiMan,-2,13,8,62%,21,2023/04/06
403,1224,,Lippo,+3,35,21,63%,56,2023/04/16
404,1224,,Waddn,-1,12,3,80%,15,2023/04/17
405,1223,,Dick Kickem,+1,77,48,62%,125,2023/04/12
406,1223,,matwyr,-2,15,8,65%,23,2023/04/15
407,1223,,Adrian Calu,-1,24,9,73%,33,2023/04/06
408,1222,,Madskill^^,-1,76,47,62%,123,2023/04/17
409,1221,,type97tiha,-5,27,16,63%,43,2023/04/04
410,1221,,rain,+3,7,3,70%,10,2023/04/17
411,1221,,MaYoR,-1,55,33,63%,88,2023/04/17
412,1221,,Angry Android,+1,25,14,64%,39,2023/04/10
413,1220,,aSIIdeceiv3r,+1,19,10,66%,29,2023/03/26
414,1220,,MauserTeleri,-2,10,6,63%,16,2023/03/22
415,1219,,Turin,+2,29,17,63%,46,2023/04/04
416,1219,,lp,+4,9,3,75%,12,2023/04/16
417,1219,,naughtynazi,-1,21,11,66%,32,2023/04/17
418,1219,,Boss kachalky,-2,9,4,69%,13,2023/03/22
419,1219,,Hodolf,-2,50,27,65%,77,2023/04/12
420,1219,,All Day,+1,26,12,68%,38,2023/04/16
421,1218,,yunusG35,-1,60,40,60%,100,2023/04/16
422,1218,,Homeless,+1,27,14,66%,41,2023/04/10
423,1218,,Junkz,+3,16,9,64%,25,2023/03/31
424,1217,,Neko,+6,39,24,62%,63,2023/04/04
425,1217,,Azxc,-1,27,14,66%,41,2023/04/10
426,1217,,JULIUS,-2,40,24,63%,64,2023/04/17
427,1216,,Nebel,+2,13,6,68%,19,2023/04/17
428,1216,,Ja Sam Tvoj Bog,+2,54,35,61%,89,2023/04/15
429,1216,,OP,+5,14,6,70%,20,2023/04/02
430,1215,,Tubby,+4,19,8,70%,27,2023/04/16
431,1214,,ChocolateStarfish,+1,35,18,66%,53,2023/04/03
432,1214,,CrazyEight1994,-3,22,11,67%,33,2023/04/14
433,1214,,run,+1,7,3,70%,10,2023/03/25
434,1213,,FlAyPiGg,+8,14,5,74%,19,2023/03/30
435,1213,,Danobbit,+2,8,3,73%,11,2023/04/14
436,1213,,Panzerfaust,+3,20,12,63%,32,2023/04/18
437,1212,,BA_Flesh_WounD,+7,64,45,59%,109,2023/04/17
438,1212,,MarnyPopis,+1,25,15,63%,40,2023/04/17
439,1211,,喵了个咪,+8,32,19,63%,51,2023/04/17
440,1210,,≡[EZGK]≡ T3dgO13,+2,12,6,67%,18,2023/04/15
441,1210,,Nesli,+3,13,5,72%,18,2023/04/14
442,1210,,Invokerka,+13,23,10,70%,33,2023/04/15
443,1210,,Dullahan,+1,10,3,77%,13,2023/03/28
444,1209,,SovietBuffalo,+1,14,7,67%,21,2023/04/16
445,1209,,EG_DirtyKen,+3,20,9,69%,29,2023/04/16
446,1209,,REDACTED,-1,14,9,61%,23,2023/04/15
447,1208,,中國狗比人多,+2,57,36,61%,93,2023/04/17
448,1207,,tank,+1,17,11,61%,28,2023/04/17
449,1206,,co11to11no11,+5,15,7,68%,22,2023/04/15
450,1206,,SadAndSexy,+2,8,2,80%,10,2023/04/09
451,1206,,Terawu,+2,24,16,60%,40,2023/04/17
452,1205,,Trivolka,+1,20,11,65%,31,2023/04/17
453,1205,,[IRS] EBass,-1,36,20,64%,56,2023/04/08
454,1204,,tubagznyven,+1,32,26,55%,58,2023/04/16
455,1204,,Florian Geyer von Giebelstadt,+1,17,9,65%,26,2023/04/10
456,1203,,loovus,+1,19,12,61%,31,2023/04/15
457,1203,,Stormless,-1,24,12,67%,36,2023/04/16
458,1201,,Tibia,-2,10,5,67%,15,2023/03/21
459,1201,,Core,-1,15,5,75%,20,2023/04/10
460,1201,,50uz83rw,-3,16,8,67%,24,2023/03/23
461,1201,,Killervirus,+7,16,9,64%,25,2023/04/14
462,1200,,Fat Nanny,+5,24,12,67%,36,2023/04/13
463,1200,,mstcrstn,+1,14,10,58%,24,2023/04/15
464,1199,,GhostVengeance,-1,9,3,75%,12,2023/04/14
465,1199,,Vettlen,-1,19,12,61%,31,2023/04/17
466,1199,,Heckmek,+1,9,4,69%,13,2023/03/24
467,1199,,Beregonds,+1,15,8,65%,23,2023/04/05
468,1198,,spz,+2,54,32,63%,86,2023/04/17
469,1198,,fefsan,+1,62,46,57%,108,2023/04/17
470,1197,,Sharpg,+2,22,14,61%,36,2023/04/17
471,1197,,suomenpaskin,-1,37,27,58%,64,2023/04/04
472,1197,,lupoy,+1,9,4,69%,13,2023/04/17
473,1196,,snekasan,+2,38,24,61%,62,2023/04/17
474,1196,,熬夜会秃头,+3,95,79,55%,174,2023/04/17
475,1195,,陈老以,+2,14,6,70%,20,2023/03/26
476,1195,,alu,+3,26,15,63%,41,2023/03/21
477,1195,,Pano_ramix,+5,61,47,56%,108,2023/04/15
478,1194,,yes,-1,26,13,67%,39,2023/03/25
479,1194,,Free Phalanx,+1,143,118,55%,261,2023/04/16
480,1194,,Kroll,+1,10,5,67%,15,2023/04/09
481,1193,,eybe,-1,14,8,64%,22,2023/04/06
482,1193,,Kaypen97,+1,10,5,67%,15,2023/03/24
483,1192,,Tommo,+3,60,44,58%,104,2023/04/14
484,1191,,Sukulaku,+2,13,5,72%,18,2023/04/12
485,1191,,C.G. Jung,-4,26,14,65%,40,2023/04/14
486,1191,,BreadMarshLivePlace,+1,9,4,69%,13,2023/03/26
487,1191,,BiliBili 乂 神帕斯狼,-3,51,39,57%,90,2023/04/03
488,1191,,TheBlartySurfer,-1,8,5,62%,13,2023/04/07
489,1190,,Templariusz,-1,8,3,73%,11,2023/04/13
490,1188,,phx.Mohikaner,+3,22,12,65%,34,2023/04/17
491,1188,,Adam,+5,52,34,60%,86,2023/04/17
492,1188,,BadmanLarry,-1,63,42,60%,105,2023/04/12
493,1188,,[WD44] Judge,-1,26,14,65%,40,2023/04/16
494,1187,,BotBot,+6,15,5,75%,20,2023/04/07
495,1187,,twitch.tv/IL2_live,+2,45,35,56%,80,2023/04/15
496,1187,,Zaterner,-1,10,4,71%,14,2023/04/17
497,1187,,tagilla,-2,17,12,59%,29,2023/04/08
498,1186,,bluegreen,+4,15,6,71%,21,2023/03/30
499,1186,,I Find A Computer Indispensable,+4,17,10,63%,27,2023/03/30
500,1186,,Dumdidaj,+1,10,3,77%,13,2023/03/23
501,1186,,yeah,+5,8,2,80%,10,2023/03/30
502,1186,,只愛❤毛妹,+5,23,12,66%,35,2023/04/13
503,1185,,Laughing Sun,+5,12,6,67%,18,2023/03/21
504,1185,,RIZAs,-1,12,7,63%,19,2023/03/31
505,1185,,恩恩,-2,45,31,59%,76,2023/04/14
506,1184,,tya12,+7,21,9,70%,30,2023/04/01
507,1184,,✪ Wesker,+1,42,25,63%,67,2023/04/17
508,1183,,kennyemmy,+7,8,2,80%,10,2023/03/29
509,1183,,Major Striker,+5,11,5,69%,16,2023/04/13
510,1182,,Gamer_Genius|Erice,-1,14,8,64%,22,2023/04/17
511,1182,,Korto,+7,27,20,57%,47,2023/04/07
512,1182,,King Jelly Chip Chip,+1,9,3,75%,12,2023/04/04
513,1181,,lubi,+5,19,12,61%,31,2023/04/14
514,1181,,The Sage,-1,11,8,58%,19,2023/04/07
515,1181,,StorageRoom,-1,27,17,61%,44,2023/04/16
516,1181,,That Guy!,+2,35,26,57%,61,2023/03/24
517,1180,,B3rr3x,+1,30,18,63%,48,2023/04/17
518,1180,,IULIUS,+1,8,3,73%,11,2023/03/28
519,1180,,GrIMM,-1,58,44,57%,102,2023/03/24
520,1180,,Dur3X,+2,13,6,68%,19,2023/04/09
521,1179,,Jokz,+1,13,8,62%,21,2023/03/29
522,1179,,Add3,+3,22,13,63%,35,2023/04/07
523,1179,,Hing-gi,+2,28,14,67%,42,2023/03/26
524,1178,,montag,-2,41,25,62%,66,2023/04/07
525,1178,,GeeNo,+1,11,5,69%,16,2023/04/12
526,1178,,Max1boy,+1,11,3,79%,14,2023/03/31
527,1177,,VIETKAMPFGROUPE,+5,106,90,54%,196,2023/04/17
528,1177,,RepoRogue,+1,12,6,67%,18,2023/04/13
529,1177,,Uncle Iroh,-1,22,14,61%,36,2023/03/23
530,1177,,awayan,+6,39,26,60%,65,2023/04/17
531,1176,,Spedgar,-1,7,4,64%,11,2023/04/15
532,1176,,The_Mad_Hat,+2,9,5,64%,14,2023/04/07
533,1176,,Dr. Gore,+2,12,8,60%,20,2023/04/08
534,1175,,Snoop',+3,29,17,63%,46,2023/03/25
535,1175,,DatFred,+2,30,19,61%,49,2023/04/05
536,1175,,IJkoek,+6,34,26,57%,60,2023/04/17
537,1173,,Retyayre,+1,8,4,67%,12,2023/04/16
538,1173,,ahegao blade,-3,16,9,64%,25,2023/04/12
539,1173,,AltopS,+2,35,25,58%,60,2023/04/16
540,1173,,Nekrophage,+4,47,31,60%,78,2023/03/22
541,1172,,SquishyMuffin,+2,15,9,63%,24,2023/04/04
542,1172,,Storm,+2,7,3,70%,10,2023/03/25
543,1171,,DALT11,+3,12,6,67%,18,2023/03/25
544,1171,,mor117,+2,99,78,56%,177,2023/04/16
545,1171,,iaguz,-2,8,5,62%,13,2023/03/22
546,1170,,Loco_YaYo,-1,34,22,61%,56,2023/04/16
547,1169,,Envisionaried,+1,27,16,63%,43,2023/04/12
548,1168,,RICO,+1,10,4,71%,14,2023/03/31
549,1168,,JJuKKuRi,-1,25,15,63%,40,2023/04/15
550,1168,,-Horst,+2,7,3,70%,10,2023/04/01
551,1168,,Adadis,+1,14,7,67%,21,2023/04/11
552,1168,,Lick3tySplit,-1,13,9,59%,22,2023/04/05
553,1167,,SGTFigy,+4,12,5,71%,17,2023/04/10
554,1167,,Khan,+5,9,4,69%,13,2023/03/30
555,1167,,Draj,-1,13,10,57%,23,2023/04/01
556,1167,,불꽃남자박상준,+2,18,11,62%,29,2023/04/13
557,1166,,ZiggyBig,+1,18,10,64%,28,2023/04/09
558,1166,,Joel,+1,15,10,60%,25,2023/04/09
559,1166,,karl,-1,12,5,71%,17,2023/04/14
560,1165,,Walruswrangler,-6,31,23,57%,54,2023/04/04
561,1165,,Kübelwagen!,+1,16,9,64%,25,2023/04/15
562,1165,,Nebula,-1,10,6,63%,16,2023/04/06
563,1165,,marine king,-4,11,7,61%,18,2023/04/09
564,1164,,yapster,+3,11,6,65%,17,2023/04/16
565,1164,,cvvonly,-3,43,25,63%,68,2023/04/10
566,1164,,Lergen,+2,20,13,61%,33,2023/04/13
567,1163,,Playing with Magic,-2,10,5,67%,15,2023/04/07
568,1163,,cease2existt,+2,17,9,65%,26,2023/04/01
569,1163,,Speedbird,-3,58,36,62%,94,2023/04/17
570,1163,,Lieut✪LunchBox,-2,19,12,61%,31,2023/04/15
571,1163,,Boskever!?,-1,7,3,70%,10,2023/03/22
572,1163,,Srilamka,+4,28,20,58%,48,2023/04/13
573,1163,,SnooSnarry,-3,8,4,67%,12,2023/04/07
574,1163,,dylson,+4,14,9,61%,23,2023/04/14
575,1163,,blackwolf,-1,7,3,70%,10,2023/04/05
576,1163,,Shadrin,+2,130,100,57%,230,2023/04/17
577,1162,,jinkmoon2,+3,34,25,58%,59,2023/04/17
578,1162,,XBound,+2,7,3,70%,10,2023/03/25
579,1162,,Chibitz,-1,19,12,61%,31,2023/03/30
580,1162,,HERMANATOR,+2,28,19,60%,47,2023/03/26
581,1162,,豆腐同学@提不起劲,+4,34,28,55%,62,2023/04/08
582,1161,,★Colonel-zuvyna★,+5,11,6,65%,17,2023/04/16
583,1161,,2506Brigade,+2,44,31,59%,75,2023/04/10
584,1161,,SuperKeitel,-2,13,8,62%,21,2023/04/17
585,1161,,SLush,-2,9,4,69%,13,2023/03/24
586,1160,,Gnorri,+2,9,4,69%,13,2023/04/06
587,1160,,Sandwichtogo,-1,35,27,56%,62,2023/04/13
588,1159,,Kiju,+1,19,14,58%,33,2023/04/07
589,1159,,tangojuliett,-1,20,12,63%,32,2023/04/17
590,1159,,luaey14,+1,15,10,60%,25,2023/03/31
591,1159,,Lord Blackwood,-3,20,13,61%,33,2023/04/07
592,1158,,'sWiNgEz,+6,8,4,67%,12,2023/04/08
593,1158,,Joker239,+2,7,3,70%,10,2023/04/10
594,1158,,Beluga,-1,67,57,54%,124,2023/04/17
595,1158,,Sweet Pea,+1,35,23,60%,58,2023/04/07
596,1157,,J3WN1aL8T0R,+1,40,30,57%,70,2023/04/17
597,1157,,churchmf,-1,22,11,67%,33,2023/04/15
598,1157,,Ashlande,+1,23,19,55%,42,2023/04/16
599,1157,,Lil Crit,+4,16,10,62%,26,2023/04/15
600,1157,,zliiroii,-2,99,84,54%,183,2023/04/12
601,1157,,riccoriccosupershaker,+2,12,7,63%,19,2023/04/11
602,1156,,Maup,+5,9,4,69%,13,2023/04/11
603,1156,,TheMonkeyInChargeOfBananas,+2,12,8,60%,20,2023/04/07
604,1155,,DoubleDare,+1,12,6,67%,18,2023/04/09
605,1155,,Murray,-1,18,12,60%,30,2023/04/18
606,1155,,dr_squid,+1,34,23,60%,57,2023/04/16
607,1155,,老王,+1,25,14,64%,39,2023/04/06
608,1155,,pokory,+1,7,3,70%,10,2023/04/15
609,1155,,DirtyDan,+2,10,6,63%,16,2023/04/07
610,1154,,bisivan1,-3,32,21,60%,53,2023/04/14
611,1154,,Rocky0730,+1,38,34,53%,72,2023/04/17
612,1154,,ChOsHoT,+5,8,3,73%,11,2023/04/11
613,1154,,✡ Merchant ✡,-1,12,8,60%,20,2023/04/07
614,1154,,Bandit,-1,12,7,63%,19,2023/04/16
615,1154,,Les Memérables,-1,8,4,67%,12,2023/03/26
616,1153,,LB,-4,6,4,60%,10,2023/04/17
617,1153,,SuppEngineer,+4,15,8,65%,23,2023/04/12
618,1152,,Schreihalz Λ,+3,8,4,67%,12,2023/04/10
619,1152,,Testicular Chewing Goat,+1,8,4,67%,12,2023/03/22
620,1151,,伊卡洛斯,+3,8,4,67%,12,2023/04/07
621,1151,,Vedro_32,-1,10,4,71%,14,2023/04/15
622,1151,,Imaturkeith,+5,14,7,67%,21,2023/04/13
623,1151,,Faffinir,+2,8,4,67%,12,2023/04/17
624,1151,,PeterGriffin,-2,13,8,62%,21,2023/04/05
625,1151,,SteveMcQueef,-1,9,6,60%,15,2023/04/08
626,1151,,Sharp,+1,20,13,61%,33,2023/04/16
627,1150,,Synthsere,+2,10,5,67%,15,2023/04/14
628,1149,,Old Rebel,+6,18,12,60%,30,2023/04/13
629,1149,,marcmorn,+1,8,4,67%,12,2023/04/05
630,1148,,aleX ツ,+1,13,8,62%,21,2023/04/16
631,1148,,noluckystrike,-2,22,15,59%,37,2023/04/13
632,1148,,comrade14andrei,+2,14,9,61%,23,2023/03/22
633,1148,,ForFreedom,+3,10,4,71%,14,2023/04/17
634,1147,,Adonis Creed,+3,9,5,64%,14,2023/04/01
635,1147,,Slymanx,-2,19,15,56%,34,2023/03/21
636,1147,,MyFunction,-1,16,8,67%,24,2023/04/13
637,1147,,NiW,+1,16,10,62%,26,2023/04/15
638,1146,,COHORT,+2,8,4,67%,12,2023/03/21
639,1146,,The Iron Duke,+3,28,22,56%,50,2023/04/10
640,1146,,HellsHound,+1,7,3,70%,10,2023/04/04
641,1146,,Hefe,+2,75,64,54%,139,2023/04/06
642,1145,,Willyto,-3,38,31,55%,69,2023/04/16
643,1145,,butterfingers158,-1,7,3,70%,10,2023/04/09
644,1145,,Harkever,+3,33,22,60%,55,2023/04/17
645,1144,,Tuxedo Shirt Jesus,+2,90,74,55%,164,2023/04/15
646,1144,,HighFive,-1,44,30,59%,74,2023/04/17
647,1144,,ⓩᵉʳᵒ,+1,9,4,69%,13,2023/04/01
648,1144,,Marcello,-1,17,11,61%,28,2023/04/16
649,1144,,Bryan,+3,23,15,61%,38,2023/04/06
650,1144,,snOrMoL,+4,19,11,63%,30,2023/04/16
651,1144,,Leon·Scott·Kennedy,+1,6,4,60%,10,2023/04/09
652,1143,,Window Shopping,-2,93,81,53%,174,2023/04/09
653,1143,,Jet,+3,7,3,70%,10,2023/03/31
654,1143,,Patchouli Knowledge,+4,8,4,67%,12,2023/04/01
655,1142,,GuillanoBallardo,+3,11,8,58%,19,2023/03/29
656,1142,,Crovax,-3,8,5,62%,13,2023/04/06
657,1142,,Ding Dong,+1,20,14,59%,34,2023/04/16
658,1142,,Yurdle The Turtle,+1,9,5,64%,14,2023/04/07
659,1142,,Nazca,+1,11,7,61%,18,2023/03/31
660,1142,,CocusMagnus,-3,12,8,60%,20,2023/03/29
661,1141,,CasuallyLax,-1,13,8,62%,21,2023/04/13
662,1141,,Magpie,+2,7,4,64%,11,2023/04/04
663,1141,,Joachim,-1,7,4,64%,11,2023/04/03
664,1141,,k-98,+3,7,6,54%,13,2023/04/15
665,1141,,RoboRob,+2,19,15,56%,34,2023/04/13
666,1141,,S-M-O-O-K-Y,+1,11,9,55%,20,2023/04/06
667,1140,,amateur shut in,+1,40,26,61%,66,2023/04/11
668,1140,,SmeltedElk,+3,29,20,59%,49,2023/04/13
669,1140,,Soviet Duck,-1,8,5,62%,13,2023/03/26
670,1140,,starchy,-2,9,4,69%,13,2023/04/17
671,1140,,golingapanqt,-1,58,45,56%,103,2023/04/03
672,1140,,Conral,+1,8,4,67%,12,2023/04/12
673,1140,,我是人ds,+1,7,4,64%,11,2023/04/13
674,1139,,Hekezu,-1,37,29,56%,66,2023/04/09
675,1139,,GelbeBanane,+2,7,3,70%,10,2023/03/31
676,1139,,asd0963930662,+1,29,28,51%,57,2023/04/17
677,1139,,Guards,+1,10,9,53%,19,2023/04/13
678,1138,,o3koastv,-2,55,37,60%,92,2023/04/13
679,1138,,Broly,-3,13,9,59%,22,2023/04/01
680,1138,,Lyonror,-1,30,26,54%,56,2023/04/17
681,1138,,Mufasa,+3,225,198,53%,423,2023/04/10
682,1138,,Roderik,+1,24,16,60%,40,2023/04/11
683,1137,,dog,-1,39,33,54%,72,2023/04/18
684,1137,,RNGesus,-1,21,17,55%,38,2023/04/12
685,1137,,Durkslag,-1,8,5,62%,13,2023/03/27
686,1137,,mickal21,-1,15,10,60%,25,2023/04/17
687,1137,,Sh1fty,-1,16,10,62%,26,2023/03/22
688,1137,,KG_Kostov,+1,29,19,60%,48,2023/03/30
689,1136,,UBISOFT,+2,10,7,59%,17,2023/04/10
690,1136,,Dave,+1,14,8,64%,22,2023/04/17
691,1136,,BigLang,-1,20,13,61%,33,2023/04/07
692,1136,,Cpt. Aids,-1,8,4,67%,12,2023/03/22
693,1136,,Tuta,-2,10,7,59%,17,2023/04/03
694,1136,,cheems澤東,-2,9,5,64%,14,2023/03/31
695,1135,,silentbreacher,+3,10,6,63%,16,2023/04/15
696,1135,,Awesemo_4000,-1,80,65,55%,145,2023/04/11
697,1134,,pjho458,-1,20,17,54%,37,2023/04/09
698,1134,,Yoda,-1,9,5,64%,14,2023/04/05
699,1134,,headake,-1,34,25,58%,59,2023/03/24
700,1134,,matad0r4eg,+5,9,4,69%,13,2023/03/31
701,1133,,Juggermarc,-1,12,8,60%,20,2023/04/10
702,1133,,TW sss40405,-1,14,11,56%,25,2023/04/15
703,1133,,Arres,+2,7,3,70%,10,2023/04/09
704,1133,,VonLinden,+1,29,26,53%,55,2023/03/29
705,1133,,[DpS]Warlock,-1,19,12,61%,31,2023/04/09
706,1133,,espitaon,-1,8,7,53%,15,2023/03/29
707,1132,,COH3SVP,+3,9,5,64%,14,2023/04/17
708,1132,,SkeletorRAGE,-1,10,6,63%,16,2023/03/26
709,1132,,Brick_man,+1,21,16,57%,37,2023/04/01
710,1132,,Uchiha Sasuke,+4,42,40,51%,82,2023/04/15
711,1131,,88jpmm,+1,82,73,53%,155,2023/04/18
712,1131,,Moonmyung,+1,6,4,60%,10,2023/04/17
713,1131,,Socrates,+4,21,13,62%,34,2023/04/17
714,1131,,EtherealDragon,+1,33,25,57%,58,2023/04/16
715,1130,,Puffy,-1,26,19,58%,45,2023/04/15
716,1130,,Haze,+4,7,3,70%,10,2023/04/10
717,1130,,Oldenhaller,-3,51,40,56%,91,2023/04/17
718,1130,,Glacier Lazer,+2,13,7,65%,20,2023/04/05
719,1130,,FlySikk,+1,22,16,58%,38,2023/04/16
720,1130,,Virgile[FR],+1,24,19,56%,43,2023/04/14
721,1129,,GMCustom,+2,57,51,53%,108,2023/04/17
722,1129,,Pharmacist,+4,10,5,67%,15,2023/04/15
723,1129,,War_Dolphin,+3,7,4,64%,11,2023/03/24
724,1129,,lucky_ramen,+3,11,8,58%,19,2023/04/09
725,1128,,Eagle,-4,15,13,54%,28,2023/04/15
726,1128,,John Paul II,-2,14,10,58%,24,2023/04/01
727,1128,,King Matox,+1,14,10,58%,24,2023/04/10
728,1127,,LuckySpark,+1,50,43,54%,93,2023/04/17
729,1127,,Oskar,-1,32,24,57%,56,2023/03/30
730,1127,,Voodoo Mama JuJu,+1,16,9,64%,25,2023/03/29
731,1127,,TisSirTony,+1,19,11,63%,30,2023/04/17
732,1127,,Wolfsindis,-2,10,7,59%,17,2023/04/14
733,1126,,Toramdo,+2,12,10,55%,22,2023/03/26
734,1125,,Jasonメ,+1,7,5,58%,12,2023/04/06
735,1125,,AlphaOmega,+3,17,11,61%,28,2023/04/07
736,1125,,WouldULike2BeAPepper2?,-1,10,7,59%,17,2023/04/02
737,1125,,el deglingoo,-1,14,10,58%,24,2023/03/29
738,1125,,SNIPER,+1,8,4,67%,12,2023/04/07
739,1125,,Sedghammer,-2,16,10,62%,26,2023/04/10
740,1125,,Pretoryan,+3,7,3,70%,10,2023/04/10
741,1124,,空空大師,+3,23,17,58%,40,2023/04/14
742,1124,,Heywood Jablowme,+1,9,7,56%,16,2023/04/15
743,1124,,I love Tiananmen,+1,10,7,59%,17,2023/04/14
744,1124,,Andrew999,+3,17,13,57%,30,2023/03/23
745,1124,,Dezza,+2,28,17,62%,45,2023/03/30
746,1123,,A fine rectal purge,+1,12,8,60%,20,2023/03/24
747,1123,,Senator Armstrong,+2,28,22,56%,50,2023/03/29
748,1123,,nobody95,-2,17,13,57%,30,2023/04/05
749,1122,,Pizzarand,+5,12,7,63%,19,2023/04/11
750,1122,,syntox,-1,11,6,65%,17,2023/04/14
751,1122,,Ludenj,-3,7,6,54%,13,2023/03/23
752,1122,,Josef Ballin',+4,11,6,65%,17,2023/03/28
753,1122,,Sea raider,-3,33,28,54%,61,2023/03/30
754,1122,,ryanpetro,-1,23,18,56%,41,2023/03/24
755,1121,,RRREEEIII,+1,7,4,64%,11,2023/04/15
756,1121,,Lavr,+3,7,3,70%,10,2023/03/23
757,1121,,Seed19,-2,9,6,60%,15,2023/03/29
758,1121,,Rush Fan,+1,15,9,63%,24,2023/03/24
759,1121,,Ramen the Desert Noodle,-1,8,5,62%,13,2023/04/17
760,1120,,Kwarzym,+1,7,5,58%,12,2023/04/13
761,1120,,Fat Samurai,+2,11,7,61%,18,2023/04/17
762,1120,,DanteQuaylin,+2,14,8,64%,22,2023/04/08
763,1120,,Fizzysaucers,+4,319,279,53%,598,2023/04/18
764,1120,,Etiyen,-1,25,21,54%,46,2023/04/08
765,1120,,30905301,+4,18,10,64%,28,2023/04/16
766,1119,,johny247trace,-1,10,7,59%,17,2023/04/08
767,1119,,gateway21,+5,18,10,64%,28,2023/04/16
768,1118,,lSherlockl,+1,9,6,60%,15,2023/03/23
769,1118,,n0_ok,-1,13,10,57%,23,2023/04/13
770,1117,,Leninade,-1,8,4,67%,12,2023/04/09
771,1117,,Stokkelol,-2,7,5,58%,12,2023/04/08
772,1117,,Julian,+2,19,14,58%,33,2023/04/01
773,1116,,maxxximka0,-3,22,15,59%,37,2023/04/07
774,1115,,KrazyKoala,+2,10,6,63%,16,2023/04/15
775,1115,,Wintermute,+6,9,5,64%,14,2023/03/21
776,1115,,drunken JEFFERY thug,-3,35,27,56%,62,2023/04/14
777,1114,,Cider,+5,32,30,52%,62,2023/03/31
778,1114,,kdguno,-1,31,27,53%,58,2023/04/11
779,1114,,Mase316 | ♥,+3,10,6,63%,16,2023/04/12
780,1114,,MaxMonument,+1,9,6,60%,15,2023/04/06
781,1113,,-p,-1,44,37,54%,81,2023/04/15
782,1113,,Hagga,+3,34,23,60%,57,2023/04/17
783,1113,,BigGameHUnter,+7,51,37,58%,88,2023/04/09
784,1113,,XD :D :),-2,7,5,58%,12,2023/04/03
785,1113,,XQC,+1,9,6,60%,15,2023/03/24
786,1113,,SHALDUN,+2,43,29,60%,72,2023/03/29
787,1113,,Matt-Of-Doom,+3,8,4,67%,12,2023/04/02
788,1113,,Akay,+3,30,17,64%,47,2023/03/24
789,1113,,AR1996,-1,6,4,60%,10,2023/04/02
790,1112,,Sostradayu,+1,7,3,70%,10,2023/04/08
791,1112,,Freezzer,-1,8,4,67%,12,2023/03/21
792,1112,,Verluca,+3,7,3,70%,10,2023/04/02
793,1111,,Brokenstaples,+1,19,14,58%,33,2023/03/29
794,1111,,товарищ LeiFeng,+3,19,15,56%,34,2023/04/14
795,1111,,Orem,-2,8,6,57%,14,2023/04/12
796,1111,,wolfmanen,+2,8,5,62%,13,2023/03/22
797,1111,,Flex,+4,7,4,64%,11,2023/03/26
798,1111,,frogfucker,+1,27,17,61%,44,2023/04/17
799,1111,,Tóóór,-1,11,9,55%,20,2023/04/17
800,1111,,Louis_XJ,+4,15,10,60%,25,2023/04/13
801,1110,,max,-1,15,14,52%,29,2023/03/31
802,1110,,Tonmaii,+2,33,24,58%,57,2023/04/13
803,1110,,SoloWingPixy,+2,18,15,55%,33,2023/03/28
804,1109,,Espada,+1,30,22,58%,52,2023/04/17
805,1109,,pokkerguy,+1,26,16,62%,42,2023/04/14
806,1109,,Cpt.Ray,+2,15,9,63%,24,2023/04/09
807,1109,,JellyMarine,+1,62,64,49%,126,2023/04/15
808,1108,,Timothy McWhiskers,+1,8,5,62%,13,2023/03/23
809,1108,,RGDfleet,+3,13,8,62%,21,2023/04/07
810,1108,,Auto Man,+2,7,5,58%,12,2023/03/31
811,1108,,Skreddern,+1,7,5,58%,12,2023/04/09
812,1108,,JShreddy,+3,22,18,55%,40,2023/04/14
813,1107,,TheLastChaos,+1,8,5,62%,13,2023/03/23
814,1107,,McGriggles,+7,21,15,58%,36,2023/04/15
815,1107,,Seasoningmen,+2,7,4,64%,11,2023/04/02
816,1106,,MariusMarius,+4,21,15,58%,36,2023/04/15
817,1106,,ThreeOracle,-1,7,4,64%,11,2023/04/10
818,1105,,Wallaby_Trust,+1,9,5,64%,14,2023/04/11
819,1105,,Ryuzaki,-1,14,9,61%,23,2023/04/13
820,1104,,Kirov,-2,50,45,53%,95,2023/04/17
821,1104,,Sidney,+2,8,5,62%,13,2023/03/22
822,1104,,towelie,+1,5,5,50%,10,2023/04/03
823,1104,,Shadicar8,+2,25,17,60%,42,2023/04/17
824,1104,,Chimp Nipples,-1,8,5,62%,13,2023/04/03
825,1104,,Williams,-2,56,48,54%,104,2023/04/08
826,1103,,Strikeforce,+3,15,9,63%,24,2023/03/30
827,1103,,Chemicals,-1,11,7,61%,18,2023/04/11
828,1103,,Freydal,-2,112,100,53%,212,2023/04/17
829,1103,,barti06,+3,66,55,55%,121,2023/03/31
830,1102,,tommyfoxy,-1,10,6,63%,16,2023/04/17
831,1102,,Trauma,+2,16,10,62%,26,2023/04/04
832,1102,,Kitsu-chan,+1,12,10,55%,22,2023/03/21
833,1101,,ToYson,+1,11,8,58%,19,2023/04/02
834,1101,,aero,+1,8,7,53%,15,2023/04/11
835,1101,,SkalliSol,+1,8,5,62%,13,2023/04/01
836,1101,,General Feldsalat,+1,24,19,56%,43,2023/03/31
837,1101,,7UziTotingMonkeys,+1,33,30,52%,63,2023/04/10
838,1100,,HarryHook,-1,6,5,55%,11,2023/04/07
839,1100,,Viking,-2,8,6,57%,14,2023/04/15
840,1100,,Mr.Kal,+3,8,5,62%,13,2023/04/18
841,1100,,Soja,+2,16,13,55%,29,2023/03/28
842,1100,,cakesucker,+1,44,35,56%,79,2023/04/16
843,1100,,kluwejo,+1,29,20,59%,49,2023/04/04
844,1099,,Eagle_One,-2,44,37,54%,81,2023/03/22
845,1099,,Excellency,+1,12,9,57%,21,2023/04/17
846,1099,,Mattfield27,+8,16,11,59%,27,2023/04/13
847,1099,,Hawk,-2,9,7,56%,16,2023/04/02
848,1099,,76561197972578478,-2,12,10,55%,22,2023/04/09
849,1099,,poichiche69,+2,9,4,69%,13,2023/04/16
850,1099,,Ranger1408,+1,7,4,64%,11,2023/04/04
851,1099,,Cory The Gardener,-1,13,9,59%,22,2023/04/11
852,1099,,BANZAI,+1,19,12,61%,31,2023/03/30
853,1098,,AParanoidPeach,-1,31,22,58%,53,2023/04/13
854,1098,,moletsplui,-2,18,12,60%,30,2023/03/24
855,1098,,Rimjobs Anonymous,-1,8,5,62%,13,2023/04/07
856,1098,,SolvE,+1,10,7,59%,17,2023/04/14
857,1097,,Allesfresser,+1,13,11,54%,24,2023/04/01
858,1097,,5th_Terror,-4,11,10,52%,21,2023/03/29
859,1097,,AE,-3,11,11,50%,22,2023/04/07
860,1097,,CravattiSeiKumpel,+7,19,13,59%,32,2023/03/31
861,1096,,AfflicTioN,+1,25,19,57%,44,2023/04/02
862,1096,,Tarquin,-1,30,23,57%,53,2023/04/17
863,1096,,niewiem94851,-4,8,7,53%,15,2023/04/08
864,1096,,take0again,+1,8,5,62%,13,2023/04/16
865,1096,,Rifllian,-1,13,11,54%,24,2023/04/08
866,1095,,ImmobilizingGaze,-2,53,48,52%,101,2023/04/08
867,1095,,8ug8ear,+2,38,29,57%,67,2023/04/15
868,1095,,๖ۣۜF1re,+2,22,16,58%,38,2023/04/16
869,1094,,Manchego Man,+2,10,7,59%,17,2023/03/30
870,1094,,Retlocke,+1,27,26,51%,53,2023/04/17
871,1093,,SleepingGiant,+2,7,4,64%,11,2023/04/01
872,1093,,Kordi,+1,7,3,70%,10,2023/03/27
873,1093,,FitzBro,-1,36,32,53%,68,2023/04/15
874,1093,,BigCupOfTea,+2,28,21,57%,49,2023/04/18
875,1092,,wutface,+4,83,70,54%,153,2023/04/17
876,1092,,Razorgrin27,+2,157,160,50%,317,2023/04/15
877,1092,,DarthPotato,-7,33,28,54%,61,2023/04/17
878,1092,,Keizige Roker,-2,26,17,60%,43,2023/03/24
879,1092,,Saj,-1,17,11,61%,28,2023/03/29
880,1091,,Makros,+1,6,5,55%,11,2023/03/28
881,1091,,APGCobra,+4,8,5,62%,13,2023/03/23
882,1091,,ironicusername17,-1,24,18,57%,42,2023/04/14
883,1091,,Sojourner,+2,7,4,64%,11,2023/04/08
884,1091,,MrGiio98,-1,6,4,60%,10,2023/04/16
885,1090,,Enlightened Enlisted,+2,18,14,56%,32,2023/03/21
886,1090,,N3oX,-1,42,38,53%,80,2023/04/01
887,1090,,UncleSpam®,-1,8,4,67%,12,2023/04/12
888,1089,,Ladabaz,+2,7,3,70%,10,2023/04/05
889,1089,,dr.farsh,-1,18,12,60%,30,2023/04/09
890,1089,,Colonel Cumhog,-1,42,40,51%,82,2023/03/21
891,1089,,RadialEngine,+1,9,5,64%,14,2023/04/16
892,1089,,cool_mint_flavor,+6,8,4,67%,12,2023/03/23
893,1088,,Taiwan-SJALVIN,-2,27,21,56%,48,2023/04/13
894,1088,,MR_BLORB,+2,14,11,56%,25,2023/03/27
895,1087,,S0_GosU,+2,11,8,58%,19,2023/03/30
896,1087,,BeardedOaf,-1,15,12,56%,27,2023/03/30
897,1087,,SteelMan,+2,67,54,55%,121,2023/04/18
898,1087,,Anbora,+4,6,4,60%,10,2023/04/15
899,1086,,erectusapes,-3,12,10,55%,22,2023/04/16
900,1086,,Bineto,+2,36,30,55%,66,2023/04/18
901,1086,,Antiunfall,-1,7,6,54%,13,2023/04/17
902,1086,,MAZA_(Rus),-1,14,13,52%,27,2023/04/03
903,1086,,jay,-2,43,37,54%,80,2023/04/02
904,1086,,BruinTzar,-1,29,24,55%,53,2023/04/16
905,1086,,Evil Bunz,-1,14,17,45%,31,2023/04/02
906,1086,,CPU-Easy,-1,18,12,60%,30,2023/03/29
907,1085,,The Almighty Wanka,+1,52,53,50%,105,2023/04/14
908,1085,,Sercodttv,+3,8,5,62%,13,2023/04/03
909,1085,,hnidex,-2,16,11,59%,27,2023/03/29
910,1084,,Magma,+1,7,4,64%,11,2023/04/10
911,1084,,KampfLachs,+2,12,8,60%,20,2023/04/17
912,1084,,🏹tȟogktékA🔪💀🪓,-2,62,57,52%,119,2023/04/07
913,1083,,Kemp,-1,28,26,52%,54,2023/03/26
914,1083,,AngelSSword,-1,11,9,55%,20,2023/04/17
915,1083,,Wywtigerking,-2,12,11,52%,23,2023/04/14
916,1083,,SunTzu,+2,7,4,64%,11,2023/03/21
917,1082,,Furioushofman,-2,63,58,52%,121,2023/04/13
918,1082,,Ура!,-1,8,5,62%,13,2023/04/16
919,1082,,PrinzIgor,-1,17,12,59%,29,2023/04/07
920,1081,,39TH GUARDS POTATO REGIMENT,+1,8,6,57%,14,2023/04/07
921,1081,,Mr. Purple,-2,75,70,52%,145,2023/04/17
922,1081,,Melon121,-1,52,46,53%,98,2023/04/09
923,1081,,WazzaBozza,-2,8,6,57%,14,2023/04/08
924,1081,,Private_Schneewittchen,+2,9,7,56%,16,2023/04/10
925,1081,,Nasser,-1,56,44,56%,100,2023/03/31
926,1081,,郁金香哪有你的浴巾香,+2,8,7,53%,15,2023/04/14
927,1080,,Goldeneale,-4,7,5,58%,12,2023/04/11
928,1080,,MarsAttacks,+2,40,34,54%,74,2023/04/18
929,1080,,EastHawk,+1,42,37,53%,79,2023/04/13
930,1080,,Younior,-3,9,7,56%,16,2023/04/16
931,1079,,Globalnaya,-1,6,4,60%,10,2023/03/31
932,1079,,rakutuki,+2,8,5,62%,13,2023/03/27
933,1079,,CommandoSweat,+2,9,8,53%,17,2023/04/09
934,1079,,The Murloc Redneck,+3,7,5,58%,12,2023/04/04
935,1079,,Wind,-1,7,5,58%,12,2023/03/29
936,1079,,TheWolf,-1,8,4,67%,12,2023/03/24
937,1078,,Sentinel pls,-2,12,14,46%,26,2023/04/12
938,1078,,Mentat,+1,28,24,54%,52,2023/04/16
939,1078,,Royal Annihilator,-3,15,14,52%,29,2023/04/06
940,1078,,百年皇家烤香肠,+2,9,7,56%,16,2023/04/03
941,1078,,JohnGrammaticus,-2,24,21,53%,45,2023/04/09
942,1078,,DeezNuts,+2,8,4,67%,12,2023/04/02
943,1078,,Vichunt_st,-1,9,6,60%,15,2023/04/15
944,1077,,Sestrum,+1,19,15,56%,34,2023/04/13
945,1077,,luproxis,-1,17,12,59%,29,2023/03/27
946,1077,,Smoking Hans,+1,13,8,62%,21,2023/04/07
947,1076,,[2.FJg]Radroach -Schtz,-2,8,7,53%,15,2023/04/07
948,1076,,The Eye of Twilight,-1,8,7,53%,15,2023/03/26
949,1076,,KevlarTax,+2,11,7,61%,18,2023/04/15
950,1075,,RunningWithFate,+1,33,26,56%,59,2023/04/17
951,1074,,Imperial NEDcoat,-1,11,11,50%,22,2023/03/28
952,1074,,Mondieu the puffin,+2,10,8,56%,18,2023/04/17
953,1074,,只因你太美,+7,15,10,60%,25,2023/04/14
954,1074,,Jones,+1,8,7,53%,15,2023/03/26
955,1074,,犀利哥0577,+2,10,7,59%,17,2023/04/15
956,1074,,AzelfandQuilava,+2,11,9,55%,20,2023/04/17
957,1074,,Wagner,+3,30,25,55%,55,2023/04/10
958,1073,,Walkerthon,+3,6,4,60%,10,2023/03/28
959,1073,,Azely,-2,16,14,53%,30,2023/04/15
960,1073,,fary2,+2,38,29,57%,67,2023/04/14
961,1073,,Kenneth,+2,21,17,55%,38,2023/04/08
962,1072,,Mister A.K.,-1,47,35,57%,82,2023/04/11
963,1071,,Kaiser Soze,-2,17,16,52%,33,2023/04/16
964,1071,,The Dude,-2,6,5,55%,11,2023/04/17
965,1071,,Faust,-1,33,26,56%,59,2023/04/03
966,1071,,Helicopter Gunner,+5,26,19,58%,45,2023/04/13
967,1071,,Hachald,+4,6,4,60%,10,2023/04/04
968,1071,,Stick,+5,9,6,60%,15,2023/04/13
969,1071,,FeiLong飛龍,-1,14,9,61%,23,2023/04/14
970,1071,,Mr.Swagman ^^,-2,11,8,58%,19,2023/04/14
971,1070,,Dance2Noel,+1,23,21,52%,44,2023/04/14
972,1070,,米勒上尉★John millers.us,+2,17,11,61%,28,2023/04/12
973,1070,,ryuklikesapples,+1,15,10,60%,25,2023/04/08
974,1070,,Highrish,-1,8,6,57%,14,2023/03/23
975,1070,,GRIFFO,+3,27,20,57%,47,2023/03/27
976,1069,,Mantra,-2,9,7,56%,16,2023/03/25
977,1069,,Qrac,-1,91,78,54%,169,2023/04/17
978,1069,,Reshala,-1,21,15,58%,36,2023/04/16
979,1069,,Major Gladouze,+3,22,14,61%,36,2023/04/09
980,1069,,Ookiemouth,-1,13,11,54%,24,2023/04/17
981,1069,,Uncle Soekarno,+1,12,11,52%,23,2023/04/11
982,1069,,Killhold,+3,14,13,52%,27,2023/04/10
983,1069,,Devrye,-1,7,6,54%,13,2023/04/09
984,1069,,Kronkers,+1,26,23,53%,49,2023/04/12
985,1068,,L. Vorenus,-1,14,10,58%,24,2023/04/12
986,1068,,nepuherUA,+2,28,24,54%,52,2023/04/06
987,1068,,skylight,+1,13,9,59%,22,2023/04/15
988,1068,,AndreMafia,+2,30,26,54%,56,2023/04/17
989,1068,,BeefSirPreme,-2,156,144,52%,300,2023/04/16
990,1068,,Localised Aurora Borealis,-2,6,5,55%,11,2023/03/30
991,1067,,TheKingofRome,+1,5,5,50%,10,2023/04/07
992,1067,,BaconXL,+1,24,20,55%,44,2023/04/17
993,1067,,Fantyx,+3,7,5,58%,12,2023/03/30
994,1067,,Project Reality King,-1,34,31,52%,65,2023/04/04
995,1067,,Lieutenant Guy,+2,13,10,57%,23,2023/04/14
996,1067,,sormi,-1,11,9,55%,20,2023/04/07
997,1066,,Tato,-3,35,33,51%,68,2023/04/15
998,1066,,Dansara,-1,11,10,52%,21,2023/03/31
999,1066,,HamSAMwich,+5,12,11,52%,23,2023/04/01
1000,1066,,BrockSamson,+2,37,33,53%,70,2023/04/07
1001,1066,,Neon-Reactionary,-2,6,6,50%,12,2023/04/17
1002,1066,,Pacman - Animarchy,+5,10,9,53%,19,2023/04/16
1003,1066,,zyk1999,+3,19,14,58%,33,2023/04/02
1004,1065,,Samp,-5,23,23,50%,46,2023/04/16
1005,1065,,Rex Everything,-1,11,7,61%,18,2023/04/08
1006,1065,,MeiserMonkey,+2,8,7,53%,15,2023/04/15
1007,1065,,Asrach,+2,15,13,54%,28,2023/03/30
1008,1065,,William J,+1,20,19,51%,39,2023/04/04
1009,1065,,danrylee,+1,46,39,54%,85,2023/03/29
1010,1065,,lappodamy,+2,24,26,48%,50,2023/04/17
1011,1064,,Superstar Rich Evans,-1,27,21,56%,48,2023/04/17
1012,1064,,Lemon and Apples,-1,12,11,52%,23,2023/04/11
1013,1064,,Darbesky,-3,50,38,57%,88,2023/04/04
1014,1064,,Aerozeppelin,+2,19,13,59%,32,2023/04/17
1015,1064,,Отец Егор,-1,8,7,53%,15,2023/03/24
1016,1064,,LiffLaffLuff,-2,10,9,53%,19,2023/04/06
1017,1063,,Diabulax,-2,36,36,50%,72,2023/04/06
1018,1063,,Aparoid96,-1,15,13,54%,28,2023/04/15
1019,1063,,lwl,+1,6,5,55%,11,2023/03/27
1020,1062,,pwnosaurus,+3,31,29,52%,60,2023/04/17
1021,1062,,BSG,-3,30,30,50%,60,2023/04/07
1022,1062,,something,-1,10,7,59%,17,2023/04/01
1023,1061,,MeeeSHuGgaHH,+1,29,25,54%,54,2023/04/09
1024,1061,,Hasdafu,+7,19,13,59%,32,2023/03/26
1025,1061,,Azureye,+1,39,34,53%,73,2023/03/30
1026,1061,,总维新,-1,6,6,50%,12,2023/04/15
1027,1061,,Monsterpappa,+1,40,32,56%,72,2023/04/16
1028,1061,,ReadyForDisappointment,-3,17,14,55%,31,2023/04/05
1029,1061,,Cyril Figgis,-2,11,8,58%,19,2023/03/25
1030,1060,,DPdangi28,+2,21,19,53%,40,2023/04/16
1031,1060,,vbbdfych,-1,5,5,50%,10,2023/04/17
1032,1060,,mr.napalman,-1,23,19,55%,42,2023/04/15
1033,1060,,Bobtinator,+1,16,15,52%,31,2023/04/13
1034,1060,,Marmalade,-2,30,29,51%,59,2023/04/16
1035,1060,,Lowang,-1,6,4,60%,10,2023/04/04
1036,1060,,[-ODM-] Xiphos,+2,25,20,56%,45,2023/04/14
1037,1059,,Wild-Muffin,-1,7,4,64%,11,2023/04/12
1038,1059,,VndctL,-3,9,8,53%,17,2023/03/29
1039,1059,,EsP _NieTO,+1,10,8,56%,18,2023/04/15
1040,1059,,rses54,-3,11,9,55%,20,2023/04/14
1041,1059,,Purple Scout,+3,25,22,53%,47,2023/04/16
1042,1059,,tkaqkdlsdud,-1,21,20,51%,41,2023/04/17
1043,1059,,Waffles,-1,12,11,52%,23,2023/04/06
1044,1058,,qinlang70,-5,15,15,50%,30,2023/04/15
1045,1057,,Bullomas,+5,7,5,58%,12,2023/03/29
1046,1057,,CodyMody,+1,37,34,52%,71,2023/04/12
1047,1057,,Toking,-3,9,10,47%,19,2023/04/02
1048,1057,,WACA,-1,31,32,49%,63,2023/04/16
1049,1057,,Quid,+1,13,12,52%,25,2023/04/15
1050,1056,,JJB34,-2,33,29,53%,62,2023/03/22
1051,1056,,Sgt.DasheRRR,-1,50,44,53%,94,2023/04/18
1052,1056,,realDonaldTrump,+2,18,15,55%,33,2023/04/01
1053,1056,,positive energy gamer,-2,15,12,56%,27,2023/03/29
1054,1055,,gui8787,-1,6,5,55%,11,2023/04/05
1055,1055,,FF7Forever,+3,44,45,49%,89,2023/04/07
1056,1055,,Von Ribbentrop,+1,8,6,57%,14,2023/04/07
1057,1055,,Mahuna,-1,24,23,51%,47,2023/04/17
1058,1055,,qwbvvvvV,-2,9,8,53%,17,2023/04/17
1059,1054,,KOJIMA,-1,13,11,54%,24,2023/04/16
1060,1054,,shz007,-5,22,17,56%,39,2023/04/16
1061,1054,,JRocinante,-1,36,34,51%,70,2023/04/13
1062,1054,,Benji,+1,8,7,53%,15,2023/04/01
1063,1053,,Nismo,-2,8,6,57%,14,2023/03/27
1064,1053,,Snoopy,+1,15,13,54%,28,2023/04/09
1065,1053,,Foxinko,-1,11,13,46%,24,2023/04/14
1066,1053,,Danny,-1,7,6,54%,13,2023/03/21
1067,1053,,PING!( #-_-) ~~~,+5,18,18,50%,36,2023/04/16
1068,1053,,Nadzinator,+1,51,41,55%,92,2023/04/15
1069,1052,,DeathFromAbove,-4,8,9,47%,17,2023/04/02
1070,1052,,jordstg,+2,17,13,57%,30,2023/04/15
1071,1052,,Ciaphas Cain,-4,9,8,53%,17,2023/04/01
1072,1052,,Big Moist,+2,14,12,54%,26,2023/04/08
1073,1052,,905axel,-2,8,6,57%,14,2023/04/15
1074,1051,,jingleswj,+1,58,56,51%,114,2023/04/16
1075,1050,,poppe,-1,18,14,56%,32,2023/03/27
1076,1050,,Pero,-1,87,87,50%,174,2023/04/15
1077,1050,,Peter,+6,10,7,59%,17,2023/04/14
1078,1050,,kingjordy3,+7,45,39,54%,84,2023/04/09
1079,1050,,ColdBlood,-1,17,12,59%,29,2023/04/17
1080,1050,,captainbros,-2,11,10,52%,21,2023/04/07
1081,1050,,Neuromancer,+1,13,11,54%,24,2023/04/15
1082,1049,,etipp,-1,5,5,50%,10,2023/04/15
1083,1049,,Trapped in NA,-1,8,7,53%,15,2023/03/22
1084,1049,,DamanLeGentleman,-1,29,26,53%,55,2023/04/14
1085,1049,,Faramir Captain Of Gondor,+2,9,7,56%,16,2023/04/18
1086,1049,,MichaelOyster,-2,6,5,55%,11,2023/03/23
1087,1049,,Dirty T,+1,6,7,46%,13,2023/03/30
1088,1049,,Batemanis,+1,14,13,52%,27,2023/03/22
1089,1048,,HOKAGE,-1,10,9,53%,19,2023/04/15
1090,1048,,Howi,+1,71,71,50%,142,2023/04/18
1091,1048,,Patrick,-1,7,5,58%,12,2023/04/04
1092,1048,,VewDew,-2,6,5,55%,11,2023/04/18
1093,1048,,Mandude,+1,6,5,55%,11,2023/04/17
1094,1047,,ESloman,-1,7,7,50%,14,2023/04/12
1095,1047,,AF2006,+2,30,26,54%,56,2023/04/15
1096,1047,,The Major General,+1,33,33,50%,66,2023/04/15
1097,1047,,Guessmaname,-2,16,13,55%,29,2023/03/21
1098,1047,,Bacaphonic,+1,51,54,49%,105,2023/04/10
1099,1047,,kiwi,-2,6,6,50%,12,2023/04/13
1100,1047,,John 澤東,-2,12,9,57%,21,2023/04/17
1101,1046,,Ekko Tek,-3,20,20,50%,40,2023/04/07
1102,1046,,Conor08,-1,12,10,55%,22,2023/03/30
1103,1046,,Drakir,+1,10,10,50%,20,2023/04/17
1104,1046,,Bartolini ce,+1,12,10,55%,22,2023/04/14
1105,1046,,DanLo,+1,6,6,50%,12,2023/04/16
1106,1046,,Mephswall,+2,14,13,52%,27,2023/03/30
1107,1045,,Elias,-2,28,26,52%,54,2023/03/29
1108,1045,,B3r0x,+3,6,4,60%,10,2023/04/16
1109,1045,,Ros3ncrantz,-1,12,12,50%,24,2023/04/06
1110,1045,,MadeManG74,-1,18,18,50%,36,2023/04/14
1111,1045,,Nudlar,+1,28,26,52%,54,2023/04/17
1112,1045,,kim2802ks,-1,7,5,58%,12,2023/03/24
1113,1044,,bedolejsi,-1,10,9,53%,19,2023/03/25
1114,1044,,Vereki,+2,6,5,55%,11,2023/03/26
1115,1044,,Demi-Meuj,+1,6,4,60%,10,2023/04/04
1116,1043,,opalagandara,-3,62,59,51%,121,2023/04/10
1117,1043,,max,+2,17,16,52%,33,2023/03/23
1118,1043,,Eccle,+2,10,8,56%,18,2023/04/01
1119,1042,,Tsoi,-3,6,6,50%,12,2023/03/30
1120,1042,,JohnstyPonst,+3,11,8,58%,19,2023/04/06
1121,1042,,nippy,-3,79,79,50%,158,2023/04/17
1122,1041,,dbsights,+1,8,9,47%,17,2023/03/30
1123,1041,,Vince,-1,13,12,52%,25,2023/04/02
1124,1041,,Moose,+1,8,7,53%,15,2023/04/14
1125,1041,,Razor34,-2,15,12,56%,27,2023/04/17
1126,1040,,Snopel,-1,15,14,52%,29,2023/03/22
1127,1040,,Hanger,-1,25,23,52%,48,2023/04/14
1128,1040,,ßoo,+5,20,17,54%,37,2023/04/11
1129,1040,,7789878a,-2,50,46,52%,96,2023/03/29
1130,1040,,CitRus96,-5,6,7,46%,13,2023/03/28
1131,1039,,GvardiA,+2,26,20,57%,46,2023/04/09
1132,1039,,Biobazard,-3,6,6,50%,12,2023/03/25
1133,1039,,[EXD] Ant,-1,8,7,53%,15,2023/04/04
1134,1038,,ArmhairGeneral,-1,28,26,52%,54,2023/04/06
1135,1038,,jordanglez97,-2,21,18,54%,39,2023/04/03
1136,1038,,Steven Stone,-2,34,27,56%,61,2023/04/12
1137,1038,,threepwood,-2,7,6,54%,13,2023/04/08
1138,1038,,Niamhvnl,+3,8,7,53%,15,2023/04/15
1139,1038,,Nello the Tiger,+4,14,10,58%,24,2023/04/06
1140,1038,,symbolsix,+1,6,7,46%,13,2023/03/31
1141,1037,,Helicopter Pilot,-1,31,24,56%,55,2023/04/15
1142,1037,,da.zigounet,-1,20,22,48%,42,2023/04/15
1143,1037,,Risky,-3,5,6,45%,11,2023/04/12
1144,1037,,pilliquock,+1,49,48,51%,97,2023/04/17
1145,1037,,CaptainMan,+4,15,11,58%,26,2023/04/17
1146,1037,,grau,-1,6,6,50%,12,2023/03/27
1147,1036,,PouK-ON #FrenchBanBan,+1,7,5,58%,12,2023/04/17
1148,1036,,SALADIN,-1,45,39,54%,84,2023/04/16
1149,1036,,Bouda,+1,8,6,57%,14,2023/04/05
1150,1036,,鸡脚芝士,-2,75,63,54%,138,2023/04/05
1151,1036,,samwise,+1,21,18,54%,39,2023/03/25
1152,1036,,DrymM8,-2,24,23,51%,47,2023/04/17
1153,1035,,Naschfuchs,-3,10,11,48%,21,2023/04/06
1154,1035,,Tschero,-1,17,15,53%,32,2023/04/07
1155,1035,,TidaL,-1,41,34,55%,75,2023/04/15
1156,1035,,Kieran Wood 96,-1,13,10,57%,23,2023/03/24
1157,1035,,KingSeamus,+1,48,44,52%,92,2023/03/29
1158,1035,,WhiteWhale42,+2,6,5,55%,11,2023/04/01
1159,1035,,BraveDuke,+1,7,8,47%,15,2023/04/16
1160,1034,,FocXD_YT,-3,7,6,54%,13,2023/04/12
1161,1034,,chris nos,+1,7,7,50%,14,2023/04/09
1162,1034,,Team saupiquet,-1,13,12,52%,25,2023/04/15
1163,1034,,☼ Astinus ☼,+5,7,5,58%,12,2023/03/26
1164,1033,,Sharklebois,-3,10,10,50%,20,2023/04/18
1165,1033,,snafu,-1,10,9,53%,19,2023/04/05
1166,1033,,moyu郭魚,-1,12,11,52%,23,2023/04/03
1167,1033,,Punkass Beach,-1,30,29,51%,59,2023/04/17
1168,1033,,盘丝洞真好玩,+2,12,10,55%,22,2023/04/10
1169,1033,,JDFJASJ1377,-3,84,81,51%,165,2023/04/07
1170,1032,,casper,+3,6,5,55%,11,2023/04/06
1171,1032,,NobbyNobbs,-2,66,58,53%,124,2023/04/16
1172,1032,,landibert,+1,26,24,52%,50,2023/04/11
1173,1032,,FLYCAT,-1,6,4,60%,10,2023/04/15
1174,1031,,Nukite,-2,13,12,52%,25,2023/04/17
1175,1031,,TheZiplon,-4,18,19,49%,37,2023/04/13
1176,1031,,BeniSev,+1,7,6,54%,13,2023/04/16
1177,1030,,6th Mechanized,+1,14,10,58%,24,2023/04/17
1178,1030,,Grobengel,-1,30,25,55%,55,2023/04/16
1179,1030,,Cpt. Unicorn,-1,10,12,45%,22,2023/04/10
1180,1030,,sprexnico,-1,8,6,57%,14,2023/04/16
1181,1030,,Ashxu,+4,34,31,52%,65,2023/04/14
1182,1029,,IguimDoIA,+3,12,10,55%,22,2023/04/04
1183,1029,,BENTHEGARBAGEMAN,-2,6,5,55%,11,2023/04/02
1184,1029,,Death-Bringer,+2,19,15,56%,34,2023/04/16
1185,1029,,princip,-2,14,13,52%,27,2023/04/15
1186,1029,,que,+6,20,16,56%,36,2023/04/13
1187,1028,,Werido,+1,20,24,45%,44,2023/04/04
1188,1028,,La Crevette,-2,13,11,54%,24,2023/04/12
1189,1028,,Yanto,-2,8,7,53%,15,2023/04/13
1190,1028,,MiaKhalifa,-3,269,263,51%,532,2023/04/15
1191,1028,,de_prodigz,+2,84,76,53%,160,2023/04/14
1192,1027,,twitchtvflekz127,-1,22,22,50%,44,2023/04/16
1193,1027,,Cenovis,-2,15,15,50%,30,2023/04/12
1194,1026,,Captain Clix,+3,36,37,49%,73,2023/04/12
1195,1026,,obbzipobbzi,-1,5,5,50%,10,2023/04/03
1196,1026,,Sukoya,+4,6,4,60%,10,2023/04/17
1197,1026,,bigchunk1,-2,8,7,53%,15,2023/03/30
1198,1026,,Clonze,+1,13,11,54%,24,2023/03/27
1199,1026,,六文钱,+1,14,17,45%,31,2023/04/03
1200,1025,,chedca,-1,24,26,48%,50,2023/04/01
1201,1025,,Nantrix,-2,16,19,46%,35,2023/03/30
1202,1025,,Kimin,+1,33,30,52%,63,2023/04/09
1203,1025,,carter369,+1,5,5,50%,10,2023/04/08
1204,1025,,PaPaCrazy,+1,21,18,54%,39,2023/04/05
1205,1025,,blueskin,-1,7,6,54%,13,2023/03/22
1206,1025,,MarNissan,-2,18,16,53%,34,2023/04/12
1207,1024,,nigo_BR,-2,13,13,50%,26,2023/04/16
1208,1024,,EXP,-2,13,12,52%,25,2023/03/24
1209,1024,,Mishkashmoodle,-1,23,20,53%,43,2023/04/08
1210,1024,,Blarg_Master,+2,9,9,50%,18,2023/04/07
1211,1024,,Fookin' Laser Sights,-3,7,7,50%,14,2023/04/12
1212,1024,,나이트오브,-1,11,11,50%,22,2023/04/06
1213,1024,,Hendy,-3,19,18,51%,37,2023/04/15
1214,1024,,sdfx,-2,10,11,48%,21,2023/04/16
1215,1023,,Larry David,+1,21,18,54%,39,2023/03/22
1216,1023,,Troglodyte,-1,9,9,50%,18,2023/04/07
1217,1023,,BANZAI,-2,43,46,48%,89,2023/04/14
1218,1022,,SniperKeo,+1,58,54,52%,112,2023/04/15
1219,1022,,Olmak,+1,6,6,50%,12,2023/04/06
1220,1022,,ich,-1,20,19,51%,39,2023/04/17
1221,1022,,alberugi00,+1,6,5,55%,11,2023/04/01
1222,1021,,Beezlebrox,-1,8,9,47%,17,2023/03/27
1223,1021,,niki,-2,5,5,50%,10,2023/04/11
1224,1021,,Frank S-Deel Soldier,-1,17,17,50%,34,2023/04/09
1225,1021,,FuelTank,+1,21,16,57%,37,2023/03/31
1226,1020,,孤云阁 F4,-4,12,14,46%,26,2023/03/29
1227,1020,,Mapalon,+6,21,18,54%,39,2023/04/16
1228,1020,,QKQQQ,-3,30,29,51%,59,2023/04/09
1229,1019,,Digital Granny,-2,5,5,50%,10,2023/04/07
1230,1019,,AlexanderTGreat,-5,73,64,53%,137,2023/04/17
1231,1019,,jopeka,-2,16,13,55%,29,2023/04/17
1232,1019,,LosBastardo,+1,17,15,53%,32,2023/04/02
1233,1019,,kalimania,-1,5,6,45%,11,2023/04/17
1234,1019,,blizzh1,-1,23,22,51%,45,2023/03/24
1235,1018,,Fraszerrr,+1,30,26,54%,56,2023/04/16
1236,1018,,Panzer64,-3,22,19,54%,41,2023/04/13
1237,1018,,Kruss,-1,6,7,46%,13,2023/04/15
1238,1018,,Shingles,-1,8,7,53%,15,2023/04/17
1239,1018,,Sev,-4,18,16,53%,34,2023/04/04
1240,1018,,Kronos1110,-3,5,5,50%,10,2023/03/22
1241,1018,,Steiner85,+2,6,5,55%,11,2023/04/05
1242,1018,,Edwig,+2,20,16,56%,36,2023/04/17
1243,1017,,Iraky,+1,11,10,52%,21,2023/03/24
1244,1017,,GhOsT??? :),-2,6,6,50%,12,2023/04/04
1245,1017,,Jill Valentine,+1,12,15,44%,27,2023/04/04
1246,1017,,BlaBla,-2,12,13,48%,25,2023/04/12
1247,1017,,김치 도깨비,-2,6,5,55%,11,2023/03/22
1248,1017,,Zuntew...,-2,16,17,48%,33,2023/04/16
1249,1017,,ADOLFO_CABRERA,-1,18,15,55%,33,2023/04/04
1250,1016,,Pletskud,-3,18,15,55%,33,2023/03/22
1251,1016,,Majax,-2,24,17,59%,41,2023/04/09
1252,1016,,MosMan,-1,8,6,57%,14,2023/04/01
1253,1016,,0olong,+2,17,16,52%,33,2023/03/31
1254,1016,,Myrn,+1,12,11,52%,23,2023/04/15
1255,1015,,Dreamerpython,+2,22,23,49%,45,2023/03/29
1256,1015,,pycholon,+3,8,7,53%,15,2023/04/09
1257,1015,,Ghaspar,+4,8,6,57%,14,2023/03/21
1258,1015,,MTN_Bergzwerg,+2,5,5,50%,10,2023/04/01
1259,1015,,Raven,-3,6,5,55%,11,2023/03/26
1260,1014,,marmoute,+2,7,7,50%,14,2023/04/02
1261,1014,,Sinverguenza,-1,8,8,50%,16,2023/04/04
1262,1014,,Fila,-1,20,15,57%,35,2023/04/16
1263,1014,,darkyBRO,+2,6,6,50%,12,2023/04/17
1264,1014,,NachoVidanal,+1,46,45,51%,91,2023/03/25
1265,1014,,Mattlas,-3,35,30,54%,65,2023/04/03
1266,1013,,梦京华,+4,15,12,56%,27,2023/04/16
1267,1013,,Tiraskis,+5,51,48,52%,99,2023/03/29
1268,1013,,Ares,-2,6,7,46%,13,2023/03/29
1269,1013,,SergeSeal,-6,20,22,48%,42,2023/04/09
1270,1013,,CryPsyco,-1,14,16,47%,30,2023/04/14
1271,1013,,Hostis,-2,30,28,52%,58,2023/04/10
1272,1012,,DMPhobos,-1,6,6,50%,12,2023/03/25
1273,1012,,steven.gibbs18,-5,28,29,49%,57,2023/04/05
1274,1012,,whallo14,-3,24,20,55%,44,2023/04/17
1275,1011,,Ztorm,-5,13,12,52%,25,2023/04/06
1276,1011,,cod1933,-5,56,54,51%,110,2023/04/08
1277,1011,,Cleas,-1,10,12,45%,22,2023/04/16
1278,1011,,Mustaach,-1,9,8,53%,17,2023/04/06
1279,1011,,NorthWestFresh,-2,8,8,50%,16,2023/04/09
1280,1011,,IIIIIIIIIIIIIIIII:-P,+1,10,8,56%,18,2023/04/04
1281,1010,,Sorry,-1,12,11,52%,23,2023/04/14
1282,1010,,Winstons_Ball,+1,5,6,45%,11,2023/04/17
1283,1010,,LotDExile,+2,13,13,50%,26,2023/04/14
1284,1010,,Bakummba,+2,13,13,50%,26,2023/04/09
1285,1009,,EXT1NCT1ON,-1,20,19,51%,39,2023/04/06
1286,1009,,PainAE,+2,5,6,45%,11,2023/03/26
1287,1009,,二条院羽月,-1,10,12,45%,22,2023/04/16
1288,1009,,Movai,-1,6,6,50%,12,2023/04/01
1289,1009,,Nacho Fan Sandy Ravage,+1,33,31,52%,64,2023/04/17
1290,1008,,Sophia,-2,18,16,53%,34,2023/03/23
1291,1008,,Dikuso,+1,15,14,52%,29,2023/04/17
1292,1008,,Maltez94,-2,13,12,52%,25,2023/04/10
1293,1008,,MagicPants,+1,14,14,50%,28,2023/04/12
1294,1008,,[CH]L1nux117,+2,9,8,53%,17,2023/03/26
1295,1007,,MasterBaby J,+1,5,6,45%,11,2023/04/15
1296,1007,,ll R2D2 ll,+1,6,5,55%,11,2023/04/16
1297,1007,,Cinder,-1,5,5,50%,10,2023/04/17
1298,1007,,Twitch.tv/DirtyKar1,+1,8,7,53%,15,2023/04/15
1299,1007,,无人永生,+4,157,161,49%,318,2023/04/15
1300,1007,,Dalian,-1,24,21,53%,45,2023/03/23
1301,1007,,RogueTrooper34,-1,11,12,48%,23,2023/04/14
1302,1006,,Mason,+2,11,9,55%,20,2023/03/27
1303,1006,,Tobi1234,-4,22,24,48%,46,2023/04/10
1304,1006,,StarSoulZ,+1,14,15,48%,29,2023/03/24
1305,1006,,犬,+1,5,5,50%,10,2023/04/02
1306,1005,,Trigger,+1,13,14,48%,27,2023/04/08
1307,1005,,Mungo,-2,12,15,44%,27,2023/04/09
1308,1005,,Novacaine,-2,6,6,50%,12,2023/03/23
1309,1005,,tracer,-4,8,10,44%,18,2023/04/16
1310,1004,,klop1324,+1,8,9,47%,17,2023/04/15
1311,1004,,chochomie,+1,11,12,48%,23,2023/03/25
1312,1004,,SmoothieOutOfGoofy,-1,8,7,53%,15,2023/04/09
1313,1004,,Mortar Punch,-2,10,11,48%,21,2023/03/26
1314,1004,,kinG_shrimP,+4,9,9,50%,18,2023/04/08
1315,1004,,Whisky,+2,19,20,49%,39,2023/03/29
1316,1004,,Marshal Georgy Zhukov,+1,4,6,40%,10,2023/04/01
1317,1003,,SimpleLuke,+1,5,5,50%,10,2023/03/31
1318,1003,,Seb343,-5,24,25,49%,49,2023/04/10
1319,1003,,chl00100010,+1,6,9,40%,15,2023/04/09
1320,1003,,DeathBringeR,-4,16,17,48%,33,2023/04/17
1321,1002,,Mook Spits,-2,6,8,43%,14,2023/04/01
1322,1002,,Der_Therapeut,+1,5,5,50%,10,2023/04/05
1323,1002,,Frog,-1,15,13,54%,28,2023/04/03
1324,1002,,KleinMeser,-1,5,5,50%,10,2023/03/28
1325,1002,,Willie2K,-1,6,7,46%,13,2023/04/18
1326,1001,,MexinTexan,-5,33,38,46%,71,2023/04/01
1327,1001,,kiwisteel_95,+2,6,5,55%,11,2023/04/12
1328,1001,,Bambiswald,-1,6,6,50%,12,2023/04/12
1329,1001,,Chorbs,-2,9,9,50%,18,2023/03/22
1330,1000,,Hagiko,-2,15,14,52%,29,2023/04/14
1331,1000,,Hold The Door,-1,5,5,50%,10,2023/03/21
1332,1000,,995864543,-2,48,50,49%,98,2023/04/17
1333,1000,,AustrianBastard,-2,7,7,50%,14,2023/04/06
1334,1000,,BernieSandwiches,-1,45,45,50%,90,2023/04/17
1335,999,,Fred G. Herbert,-1,5,5,50%,10,2023/03/25
1336,999,,Jazzyrazcalz,+1,21,15,58%,36,2023/04/10
1337,999,,Diccolo,+3,20,21,49%,41,2023/04/17
1338,999,,ShadowsSun,+1,7,7,50%,14,2023/04/01
1339,999,,Alex,+1,9,8,53%,17,2023/04/08
1340,999,,Dutschtron,+2,15,13,54%,28,2023/04/17
1341,999,,broky,-3,8,10,44%,18,2023/04/16
1342,998,,{Eliote Le Pilote},+1,45,41,52%,86,2023/04/12
1343,998,,MadTestudo,-1,19,20,49%,39,2023/04/17
1344,998,,rusty,+1,5,5,50%,10,2023/04/05
1345,998,,Jarkeböb,-3,20,17,54%,37,2023/03/23
1346,998,,Nag,-2,6,7,46%,13,2023/03/23
1347,998,,Angry Leo,+1,22,26,46%,48,2023/04/09
1348,997,,Ariel,-2,16,13,55%,29,2023/04/10
1349,997,,SlayerY,-1,17,19,47%,36,2023/04/11
1350,997,,Crucial Deluxe,+1,20,19,51%,39,2023/04/13
1351,997,,asteelec,+2,12,12,50%,24,2023/03/30
1352,997,,The Mad Mancunian,+1,75,78,49%,153,2023/04/15
1353,996,,Tank,-2,5,6,45%,11,2023/03/22
1354,996,,Atet,+1,8,7,53%,15,2023/04/04
1355,996,,Fungolox,+8,29,23,56%,52,2023/04/03
1356,996,,Tornholio,+3,21,20,51%,41,2023/04/01
1357,995,,Dr Naughty,-2,20,21,49%,41,2023/04/14
1358,995,,Eversman,-2,26,28,48%,54,2023/04/13
1359,995,,Daagon,+1,10,12,45%,22,2023/03/28
1360,995,,Flapjaaak,+1,45,47,49%,92,2023/04/17
1361,994,,Lska,-1,8,9,47%,17,2023/04/15
1362,994,,𝓞𝔅𝐼,+2,16,16,50%,32,2023/04/17
1363,994,,meganen-super,+3,6,6,50%,12,2023/03/30
1364,993,,ElemenTz_younited,-3,6,11,35%,17,2023/04/15
1365,993,,Lorbaer,+1,5,5,50%,10,2023/04/07
1366,993,,Dbotiii1111,+1,10,8,56%,18,2023/04/02
1367,993,,James Bob 007,-2,5,6,45%,11,2023/04/05
1368,993,,Cuken,-1,15,15,50%,30,2023/03/30
1369,993,,Prof. Fart's Sniff Emporium,+1,8,7,53%,15,2023/04/04
1370,993,,skx0624,-1,9,11,45%,20,2023/04/17
1371,992,,Draakul,+1,5,5,50%,10,2023/03/23
1372,992,,Jurek Kiler,-3,20,23,47%,43,2023/04/17
1373,992,,vadern117,+2,5,5,50%,10,2023/04/07
1374,992,,Megapig,-1,5,7,42%,12,2023/04/06
1375,992,,Emperor Winnie,-2,5,6,45%,11,2023/04/03
1376,991,,Khayyam,-1,15,13,54%,28,2023/03/27
1377,990,,Smokindro420,+1,7,8,47%,15,2023/03/25
1378,990,,Morbid Git,+1,5,6,45%,11,2023/04/13
1379,990,,schmidtb26,-1,14,14,50%,28,2023/04/17
1380,990,,咯咯,+1,6,6,50%,12,2023/03/24
1381,989,,CalmDownMonkey,+1,13,15,46%,28,2023/04/12
1382,989,,Gotdam,-1,18,21,46%,39,2023/03/24
1383,988,,HIGH ON FALAFEL AND RICE,-2,8,10,44%,18,2023/03/31
1384,988,,Madner,+3,5,6,45%,11,2023/04/15
1385,988,,Shakey,-2,5,8,38%,13,2023/03/26
1386,987,,凉茶,-1,7,6,54%,13,2023/04/12
1387,987,,Disi,+1,22,20,52%,42,2023/04/02
1388,987,,Killer100,+1,23,27,46%,50,2023/04/17
1389,987,,david,+2,42,46,48%,88,2023/04/14
1390,987,,Kadir,+3,12,12,50%,24,2023/03/28
1391,987,,Regolon,+1,26,27,49%,53,2023/04/17
1392,987,,Akanee^,+2,18,20,47%,38,2023/04/17
1393,987,,ShooterWorld,+6,11,9,55%,20,2023/04/06
1394,987,,野人前进,+2,5,6,45%,11,2023/04/15
1395,986,,thorvaldmjolnir,-2,18,19,49%,37,2023/04/03
1396,986,,Oms,+2,52,53,50%,105,2023/04/13
1397,986,,Ayreon333,-6,39,35,53%,74,2023/04/14
1398,985,,tanne455,+1,5,5,50%,10,2023/04/07
1399,985,,schorx_laplant,+1,11,14,44%,25,2023/04/17
1400,985,,goblin.,-1,11,11,50%,22,2023/04/14
1401,984,,KingOfTheNorf,+2,8,9,47%,17,2023/04/16
1402,984,,ManBearPig,+1,14,16,47%,30,2023/04/15
1403,984,,PRBLMS,-1,7,9,44%,16,2023/04/03
1404,984,,kenny8521040,-1,38,32,54%,70,2023/04/17
1405,984,,CDCusa,+1,8,8,50%,16,2023/04/02
1406,983,,IdARzikFTh,-1,6,8,43%,14,2023/03/28
1407,983,,BENDER,-3,79,80,50%,159,2023/03/26
1408,983,,Supersmash,-2,95,95,50%,190,2023/04/17
1409,983,,Warheads,-3,5,6,45%,11,2023/04/01
1410,982,,Uncle Grandpa,-1,5,6,45%,11,2023/04/02
1411,982,,DaReDeViL,+1,11,12,48%,23,2023/04/12
1412,982,,Thoralf,+3,7,8,47%,15,2023/04/02
1413,982,,Brexit Geezer,+1,19,18,51%,37,2023/04/13
1414,982,,LEOPARD1492,+1,17,17,50%,34,2023/04/17
1415,981,,四轮车,-2,8,9,47%,17,2023/04/04
1416,981,,Taterbait,+3,17,18,49%,35,2023/03/25
1417,981,,the Hmpf,+5,27,23,54%,50,2023/04/15
1418,980,,the doctor,-1,11,13,46%,24,2023/04/16
1419,980,,PGLee,+1,8,7,53%,15,2023/04/16
1420,980,,_MrX_,+2,5,5,50%,10,2023/04/09
1421,980,,ljr8mmjg,-1,5,6,45%,11,2023/03/22
1422,979,,bez tormozov,+4,15,13,54%,28,2023/04/08
1423,979,,lil splendid,-2,8,9,47%,17,2023/03/23
1424,979,,tomastys,-2,11,12,48%,23,2023/04/06
1425,978,,Milky Waters,-2,6,7,46%,13,2023/04/12
1426,978,,detoxicus,+1,10,11,48%,21,2023/03/28
1427,978,,Tw_Yolin,+1,13,13,50%,26,2023/04/15
1428,978,,Bacon,-1,5,6,45%,11,2023/04/17
1429,978,,Luxon 5,+1,8,9,47%,17,2023/04/13
1430,978,,bassettr,+6,14,13,52%,27,2023/04/06
1431,977,,altBoomBoom,-1,14,18,44%,32,2023/03/25
1432,977,,Sheepdogsheep,+1,5,6,45%,11,2023/03/28
1433,977,,shobbs001,+1,35,31,53%,66,2023/04/09
1434,977,,[P-CAN] ttv/cccilytf2,+1,5,6,45%,11,2023/04/02
1435,977,,HuayRa,+2,27,29,48%,56,2023/04/16
1436,976,,Tom Arteries,+2,5,5,50%,10,2023/04/17
1437,976,,KrulAsfaltuf,+2,8,9,47%,17,2023/04/03
1438,976,,pansen,-2,14,16,47%,30,2023/04/06
1439,976,,legget,+1,6,6,50%,12,2023/03/30
1440,976,,Matranus,+2,12,15,44%,27,2023/04/07
1441,976,,sVad,+1,5,6,45%,11,2023/03/29
1442,975,,Nubbl0r,+1,9,9,50%,18,2023/04/09
1443,975,,Dimairt,-1,15,13,54%,28,2023/04/04
1444,975,,Eternal_Dawn,-2,5,6,45%,11,2023/04/13
1445,975,,Temujin,-3,7,8,47%,15,2023/04/07
1446,975,,baschi,-5,40,38,51%,78,2023/04/17
1447,974,,WadoVice,-2,6,7,46%,13,2023/04/02
1448,974,,D3kay,-1,13,15,46%,28,2023/04/17
1449,973,,sleeping_dude,-1,12,12,50%,24,2023/04/17
1450,973,,enterprise9001,-3,32,36,47%,68,2023/04/02
1451,973,,Willbam,+1,12,11,52%,23,2023/04/16
1452,973,,Hans_Hackfresse,-3,16,17,48%,33,2023/04/13
1453,973,,porgboi,+1,11,11,50%,22,2023/04/13
1454,973,,infamous101,+1,4,7,36%,11,2023/04/02
1455,972,,Twarp,-1,5,5,50%,10,2023/04/14
1456,972,,Wensleydale our lord and saviour,-1,12,12,50%,24,2023/04/03
1457,971,,懒鸭,+4,6,7,46%,13,2023/04/08
1458,971,,Luz Noceda,+1,25,26,49%,51,2023/03/31
1459,970,,Plum,+3,7,8,47%,15,2023/04/13
1460,970,,awokeN 1904.,+4,10,10,50%,20,2023/03/27
1461,969,,BGJ,-1,17,20,46%,37,2023/04/01
1462,969,,cramezid,+2,6,8,43%,14,2023/04/09
1463,969,,Mako,+3,16,20,44%,36,2023/04/15
1464,969,,Bilu,+2,5,6,45%,11,2023/04/05
1465,969,,reecardo,-2,7,8,47%,15,2023/04/08
1466,968,,伐伐伐伐伐木工,-2,5,5,50%,10,2023/04/06
1467,968,,jamister911,-1,5,6,45%,11,2023/04/04
1468,968,,Stevi Wonder,+2,6,7,46%,13,2023/04/11
1469,968,,lugehorsam,-1,35,36,49%,71,2023/03/28
1470,968,,Yeidan,+1,7,7,50%,14,2023/03/30
1471,968,,misterbeige,+1,5,6,45%,11,2023/03/22
1472,968,,diegofvo,+1,50,57,47%,107,2023/04/18
1473,967,,PartTime_RebeL,-2,12,13,48%,25,2023/04/17
1474,967,,蝎子莱莱,-2,11,15,42%,26,2023/04/11
1475,967,,SlightlyCrazy,-2,8,10,44%,18,2023/03/25
1476,967,,DVR,-1,9,10,47%,19,2023/04/07
1477,966,,lukebn,-4,32,36,47%,68,2023/04/15
1478,966,,Chief,-3,20,22,48%,42,2023/04/11
1479,966,,gtmike,-1,9,9,50%,18,2023/03/30
1480,965,,Lagger,-1,70,81,46%,151,2023/04/17
1481,965,,Midti,+5,53,53,50%,106,2023/03/29
1482,965,,McCurtis,+1,20,22,48%,42,2023/03/31
1483,965,,RoGueDanneRZ,-1,5,7,42%,12,2023/04/14
1484,965,,Spicecake,-1,9,8,53%,17,2023/04/05
1485,965,,LootyLoots,+2,4,7,36%,11,2023/04/16
1486,964,,Gothic5000,-1,10,13,43%,23,2023/03/30
1487,964,,BaPikachu,-1,5,7,42%,12,2023/03/29
1488,964,,蜻蜓队长,-1,23,22,51%,45,2023/04/15
1489,964,,SulumEi,-3,6,8,43%,14,2023/04/03
1490,964,,Eltharon,+1,6,7,46%,13,2023/04/10
1491,964,,Pille,-3,9,14,39%,23,2023/04/16
1492,963,,Hardkaise,-2,10,11,48%,21,2023/03/30
1493,963,,Nefarious,-4,10,12,45%,22,2023/04/01
1494,963,,Muad'Dib,-1,14,16,47%,30,2023/03/30
1495,963,,Deathmatch,+1,28,30,48%,58,2023/04/06
1496,963,,Dolphin517,-2,24,28,46%,52,2023/04/09
1497,963,,Peter,+1,8,10,44%,18,2023/04/02
1498,962,,Superchabo,-3,6,7,46%,13,2023/04/10
1499,962,,JPman,+1,5,7,42%,12,2023/04/15
1500,962,,Stanghellini,-2,35,37,49%,72,2023/04/16
1501,962,,Rucki,+1,19,21,48%,40,2023/04/17
1502,962,,Imperator Thrax,-3,9,11,45%,20,2023/04/02
1503,962,,Trampoliere,-3,7,10,41%,17,2023/04/07
1504,961,,Brink,+1,8,9,47%,17,2023/04/16
1505,961,,Snotling,-1,5,6,45%,11,2023/03/23
1506,961,,PALPS,-1,37,38,49%,75,2023/04/10
1507,961,,Jragorian,-1,9,11,45%,20,2023/03/29
1508,961,,Че,-3,19,21,48%,40,2023/04/06
1509,961,,Night,+3,14,13,52%,27,2023/04/09
1510,960,,Craven,+1,10,11,48%,21,2023/03/29
1511,960,,OhSnap,+2,26,31,46%,57,2023/04/17
1512,960,,Virginiastadt,-7,13,17,43%,30,2023/04/15
1513,960,,anthony.21.colon,+1,6,8,43%,14,2023/04/14
1514,960,,Boss Of This Gym,-1,12,17,41%,29,2023/04/05
1515,959,,[HAN]黯舞者黑刀,-4,21,23,48%,44,2023/04/07
1516,959,,RandomScrub,-2,6,8,43%,14,2023/04/02
1517,959,,小霸王其乐无穷,-2,18,21,46%,39,2023/04/16
1518,959,,Viciousbulldog,-1,6,9,40%,15,2023/04/14
1519,959,,MaDDo (:,-1,7,8,47%,15,2023/04/16
1520,959,,raatemsholosti,-1,32,38,46%,70,2023/03/29
1521,959,,wong.wilfred,+2,5,7,42%,12,2023/04/15
1522,958,,Ultron,-3,29,32,48%,61,2023/04/09
1523,958,,Step,-3,21,23,48%,44,2023/04/14
1524,958,,lovesoo5454,-1,15,15,50%,30,2023/04/16
1525,957,,Wtx.Ranger17,+1,6,9,40%,15,2023/04/17
1526,957,,ChangCHIU,-6,5,9,36%,14,2023/03/23
1527,957,,Zealot,-4,12,14,46%,26,2023/04/12
1528,957,,Hausmeister,-2,35,37,49%,72,2023/04/16
1529,957,,Jahalabad,-1,5,6,45%,11,2023/04/09
1530,956,,jonmatrix35,+1,14,15,48%,29,2023/03/25
1531,956,,Winter,+2,7,10,41%,17,2023/04/17
1532,956,,Kimberly Jong-un,-1,9,12,43%,21,2023/04/06
1533,956,,Full Metal Jumpsuit,-1,5,6,45%,11,2023/03/29
1534,956,,RastaGotSoul,+1,6,8,43%,14,2023/04/14
1535,955,,rocketpossum,-3,11,15,42%,26,2023/04/14
1536,954,,angryoutcome,+1,6,7,46%,13,2023/03/25
1537,954,,Orb Ponderer,-1,17,22,44%,39,2023/04/17
1538,954,,mosar,-2,12,15,44%,27,2023/04/16
1539,954,,MaLaC87,-1,7,9,44%,16,2023/04/16
1540,953,,Byakuyabo,+2,26,26,50%,52,2023/04/02
1541,953,,sunny_yeung,+3,7,8,47%,15,2023/04/16
1542,952,,Shirka,+1,18,18,50%,36,2023/04/15
1543,952,,XyklonX,-1,32,46,41%,78,2023/04/14
1544,951,,Nexus,+1,12,17,41%,29,2023/04/17
1545,951,,deinhard,-2,4,6,40%,10,2023/03/29
1546,951,,Jepprey,+1,30,34,47%,64,2023/04/15
1547,950,,24,+1,50,61,45%,111,2023/04/17
1548,950,,SirPengwin,-1,4,7,36%,11,2023/04/02
1549,950,,Rehlachs,-1,6,8,43%,14,2023/04/07
1550,950,,khm107105,+1,7,9,44%,16,2023/04/01
1551,949,,Arkantos1695,-1,11,13,46%,24,2023/03/31
1552,949,,PATRIOT,+3,11,14,44%,25,2023/04/17
1553,949,,antsloveit,-3,3,8,27%,11,2023/04/16
1554,949,,Orsox,-1,63,73,46%,136,2023/04/17
1555,949,,Dr. Malma,-2,4,6,40%,10,2023/03/22
1556,949,,HostileCamper,-1,6,8,43%,14,2023/04/01
1557,948,,triplewhit,+3,5,9,36%,14,2023/04/10
1558,948,,Apollo,+2,34,39,47%,73,2023/04/16
1559,948,,Lycurgus,-1,8,11,42%,19,2023/04/12
1560,948,,DeadPhoenix,-1,25,23,52%,48,2023/03/23
1561,948,,GuyMcKnight,-2,5,9,36%,14,2023/04/09
1562,947,,k1ll4fun,-5,26,29,47%,55,2023/04/02
1563,947,,JackBauer,+1,9,11,45%,20,2023/04/10
1564,947,,Horatio,+1,8,9,47%,17,2023/04/15
1565,946,,DJ BISCUIT,-1,6,7,46%,13,2023/04/15
1566,946,,RamblinManGovia,-1,17,19,47%,36,2023/03/28
1567,946,,SUPACAUSAL,-8,54,60,47%,114,2023/04/01
1568,945,,abiat1312,-2,4,6,40%,10,2023/04/15
1569,945,,FeinerBruno,+1,5,5,50%,10,2023/04/17
1570,945,,AC_Andrea NP,-3,9,11,45%,20,2023/04/10
1571,945,,TerpeneProfile,-5,9,16,36%,25,2023/04/14
1572,944,,Tanakalaga,-1,4,6,40%,10,2023/04/01
1573,944,,Apemanx,-1,13,16,45%,29,2023/04/09
1574,944,,Alien,+3,5,6,45%,11,2023/04/14
1575,943,,Armless Guy Gaming,-3,16,19,46%,35,2023/04/17
1576,943,,Ryan,-2,5,7,42%,12,2023/04/10
1577,943,,Mocard,-2,5,9,36%,14,2023/04/13
1578,943,,spliming,-3,6,9,40%,15,2023/04/12
1579,943,,SunBro,+3,13,14,48%,27,2023/03/29
1580,943,,Phenixfeuer,-2,5,7,42%,12,2023/03/25
1581,943,,gaerbr,-2,5,8,38%,13,2023/04/08
1582,942,,God Emperor,+1,4,6,40%,10,2023/04/01
1583,941,,azur,+2,49,55,47%,104,2023/04/17
1584,940,,Zspectrez,-1,13,17,43%,30,2023/04/11
1585,940,,Bloodraven,+1,25,29,46%,54,2023/04/10
1586,940,,Baren,+2,85,94,47%,179,2023/03/31
1587,940,,LikioOo,+2,12,12,50%,24,2023/04/12
1588,940,,Wonsaty Szlachcic,+3,11,17,39%,28,2023/04/09
1589,940,,Bearly,-2,5,7,42%,12,2023/04/01
1590,939,,Kotypa,-4,4,8,33%,12,2023/04/12
1591,938,,joshco-reflect,-6,5,11,31%,16,2023/04/17
1592,938,,CarT,+1,6,8,43%,14,2023/03/22
1593,938,,Waffles,-2,4,7,36%,11,2023/03/22
1594,938,,ulm,+1,6,8,43%,14,2023/04/16
1595,937,,VirtualBoost,-2,14,19,42%,33,2023/04/09
1596,937,,Latimer,-1,8,9,47%,17,2023/04/16
1597,937,,homingngdannyuk,+1,18,21,46%,39,2023/04/14
1598,937,,P3PoX,-1,9,12,43%,21,2023/04/10
1599,937,,[E12] psbob,-3,40,42,49%,82,2023/03/28
1600,937,,Kroma,-2,4,6,40%,10,2023/04/12
1601,936,,Defender,+1,9,10,47%,19,2023/04/09
1602,936,,Bootyquake,-1,33,37,47%,70,2023/04/18
1603,936,,Goblin,-2,5,7,42%,12,2023/04/11
1604,935,,jwilliams0747,-3,13,17,43%,30,2023/03/30
1605,935,,Williamgreen,-5,14,17,45%,31,2023/04/13
1606,935,,Mr.SlippyFist,+1,4,6,40%,10,2023/04/16
1607,935,,Mr Gerbik,+2,22,27,45%,49,2023/04/16
1608,935,,Tony,-1,9,12,43%,21,2023/04/10
1609,934,,skelly,-5,13,18,42%,31,2023/04/17
1610,934,,BassAngler5000,-3,14,16,47%,30,2023/04/15
1611,934,,Heizenberg,-1,18,23,44%,41,2023/04/08
1612,934,,Senor Chang,-3,9,12,43%,21,2023/04/13
1613,934,,mate,-3,4,7,36%,11,2023/04/12
1614,934,,jokur,-2,5,7,42%,12,2023/04/10
1615,934,,IMMOTUS,+1,5,7,42%,12,2023/03/30
1616,933,,GFTDphoenix,-2,11,12,48%,23,2023/04/01
1617,933,,Fell,-3,8,11,42%,19,2023/04/02
1618,933,,Naoned,-1,21,26,45%,47,2023/04/15
1619,933,,Libanese_de_Roma,-1,4,6,40%,10,2023/04/02
1620,933,,Dat_Cat,-4,17,21,45%,38,2023/04/12
1621,932,,The General,-1,5,7,42%,12,2023/03/23
1622,931,,Timmy The Strong,-2,5,7,42%,12,2023/03/25
1623,931,,evan,-2,6,11,35%,17,2023/04/16
1624,931,,CorruptCornflake,-4,38,43,47%,81,2023/04/03
1625,930,,Allcat_PL,-3,14,20,41%,34,2023/04/16
1626,929,,๖ۣinGODweTrustۜ,-1,8,12,40%,20,2023/04/16
1627,928,,plonk,-1,16,15,52%,31,2023/03/26
1628,928,,he565,+2,59,65,48%,124,2023/04/17
1629,928,,Torch Guy,-1,5,7,42%,12,2023/03/24
1630,928,,Fabz,-3,7,11,39%,18,2023/03/31
1631,928,,MANSERVICE,-5,7,14,33%,21,2023/04/14
1632,927,,CmdrTom,-2,5,7,42%,12,2023/04/04
1633,927,,matsieron,-1,10,12,45%,22,2023/03/29
1634,927,,snipe86br,-3,11,14,44%,25,2023/03/31
1635,927,,SS20132013,+1,36,46,44%,82,2023/04/15
1636,927,,AdmiralTurtle,+1,4,7,36%,11,2023/04/11
1637,926,,daniel12l,-2,10,11,48%,21,2023/04/01
1638,926,,coromic,+1,36,39,48%,75,2023/04/02
1639,926,,舒潔衛生紙,+1,7,9,44%,16,2023/03/25
1640,926,,Thibonx,-2,22,25,47%,47,2023/04/04
1641,925,,Camaneor,+1,14,18,44%,32,2023/04/15
1642,925,,dj_pie_safety,+3,11,15,42%,26,2023/03/25
1643,925,,Wahuhi,+2,5,6,45%,11,2023/04/09
1644,925,,GoldenBoy,+1,10,13,43%,23,2023/04/03
1645,924,,jebsstar,-4,3,9,25%,12,2023/04/16
1646,924,,Slayaro,-3,9,13,41%,22,2023/04/09
1647,923,,Godless,+1,9,12,43%,21,2023/04/07
1648,923,,sebeck,-1,8,15,35%,23,2023/04/17
1649,923,,Tesla Inc,-3,27,33,45%,60,2023/04/17
1650,922,,DabHabbits,+1,23,27,46%,50,2023/04/17
1651,922,,Pustynny junak,-2,18,22,45%,40,2023/04/17
1652,922,,wckgg_87429656,-4,8,14,36%,22,2023/04/05
1653,921,,yevgen522,-2,4,6,40%,10,2023/03/29
1654,921,,Aaron,+1,146,158,48%,304,2023/04/17
1655,920,,Lemonrocks1,-2,11,18,38%,29,2023/04/04
1656,920,,2952423592,+1,71,73,49%,144,2023/04/13
1657,920,,JackOfAll,+1,7,8,47%,15,2023/04/10
1658,919,,Chris,-1,5,7,42%,12,2023/04/13
1659,919,,Krisdt,-1,26,34,43%,60,2023/04/09
1660,919,,DonStatus87,+1,6,10,38%,16,2023/04/12
1661,918,,Tomar80,-1,46,57,45%,103,2023/04/17
1662,918,,masterhex,-3,4,6,40%,10,2023/04/09
1663,918,,Relaxaurus,-2,5,9,36%,14,2023/04/17
1664,918,,HarrellNukeem,+3,6,8,43%,14,2023/03/29
1665,918,,MohaaBruce,+3,22,25,47%,47,2023/04/14
1666,918,,Talboss,-4,4,6,40%,10,2023/04/12
1667,916,,PURE_FROG,-2,10,15,40%,25,2023/04/07
1668,916,,Mr. Negative,+2,4,6,40%,10,2023/03/24
1669,916,,RN42,+1,11,19,37%,30,2023/04/17
1670,916,,svisstack,-2,3,7,30%,10,2023/03/31
1671,916,,Kackthewallan,+5,13,16,45%,29,2023/04/14
1672,916,,BestyBallz,-2,22,30,42%,52,2023/04/17
1673,915,,ANDOGNNI,-1,35,37,49%,72,2023/03/30
1674,915,,AllFox,-5,6,10,38%,16,2023/04/13
1675,914,,St. Bucko Slays the Dragon,-2,11,15,42%,26,2023/04/05
1676,914,,315oklopna,+2,12,18,40%,30,2023/04/16
1677,912,,mudcat,-6,88,96,48%,184,2023/04/17
1678,912,,HidenDeath,-1,5,7,42%,12,2023/04/02
1679,912,,michalhori,-3,27,27,50%,54,2023/04/12
1680,912,,LadyVolk,+1,9,13,41%,22,2023/04/16
1681,912,,StarTool,-2,5,10,33%,15,2023/04/05
1682,912,,SOSO,+1,6,8,43%,14,2023/04/06
1683,911,,Hans von Glocken,-3,8,10,44%,18,2023/04/10
1684,911,,rasta_poux,+2,13,16,45%,29,2023/04/07
1685,910,,Azang0,+1,4,6,40%,10,2023/03/22
1686,910,,великая Катюша,+1,4,7,36%,11,2023/04/08
1687,910,,chinchilla,-2,5,8,38%,13,2023/04/14
1688,910,,Jonnyc102,-1,19,23,45%,42,2023/04/16
1689,910,,indu,+2,5,8,38%,13,2023/03/29
1690,909,,RackemWillie,-2,10,13,43%,23,2023/04/02
1691,909,,iamcancer,+1,16,22,42%,38,2023/04/05
1692,909,,HMS Renown,+1,5,9,36%,14,2023/03/30
1693,908,,megaspoonz,-1,10,15,40%,25,2023/04/13
1694,908,,NekoKirito,+1,5,9,36%,14,2023/04/08
1695,908,,ChoiceCamp,-2,5,9,36%,14,2023/04/15
1696,907,,j.d.b.220,+1,11,14,44%,25,2023/04/17
1697,907,,Diamondback,+1,4,7,36%,11,2023/04/01
1698,906,,OdinsChosen,-5,7,11,39%,18,2023/03/28
1699,906,,蒙哥马利,-1,16,20,44%,36,2023/04/18
1700,905,,Dr TeaBaggins,-3,9,17,35%,26,2023/04/13
1701,904,,opticalfalicy,-3,8,12,40%,20,2023/03/25
1702,904,,Gary Payton II,-3,8,15,35%,23,2023/04/13
1703,904,,caseycampbel,+1,4,9,31%,13,2023/04/16
1704,904,,Spektremouse,-1,6,10,38%,16,2023/03/22
1705,904,,PrinceGoro,+4,48,71,40%,119,2023/04/16
1706,903,,The Count,+1,6,8,43%,14,2023/04/07
1707,903,,Mick,-1,18,25,42%,43,2023/04/17
1708,903,,VHSmonster,+1,8,11,42%,19,2023/04/10
1709,903,,micelus,-3,17,24,41%,41,2023/04/05
1710,902,,VonOstermann,+1,16,21,43%,37,2023/03/21
1711,902,,疯狂梅西,+1,20,26,43%,46,2023/04/17
1712,902,,Mackattack,+1,5,8,38%,13,2023/04/04
1713,901,,Gulldan,+1,11,18,38%,29,2023/04/01
1714,901,,close(dry pull),-1,10,12,45%,22,2023/03/31
1715,900,,El'Drazzle,+1,25,32,44%,57,2023/04/08
1716,900,,Little_nemo,-1,13,22,37%,35,2023/04/17
1717,899,,Zaziggi,+2,8,14,36%,22,2023/04/05
1718,899,,Im_Gary,-1,10,16,38%,26,2023/04/07
1719,899,,G0dm0de,-1,9,15,38%,24,2023/04/14
1720,899,,Biopiccolo,-5,15,21,42%,36,2023/04/09
1721,899,,Ultraprimat,-1,15,23,39%,38,2023/04/16
1722,899,,FIRSTCLASS,+1,48,57,46%,105,2023/04/11
1723,898,,Drag0nRiderz,-3,10,19,34%,29,2023/04/03
1724,898,,finneranbilly,-1,7,10,41%,17,2023/04/12
1725,898,,Major R. Sole,-5,5,10,33%,15,2023/04/14
1726,897,,wayneo0,+1,11,16,41%,27,2023/04/08
1727,897,,carterpking,-1,29,35,45%,64,2023/04/17
1728,897,,The tin man,-1,7,12,37%,19,2023/04/15
1729,896,,imperator,-1,7,11,39%,18,2023/03/26
1730,896,,VincentVanDough,-3,41,42,49%,83,2023/04/02
1731,896,,Samir22,+1,78,84,48%,162,2023/03/24
1732,896,,Galooph,-3,9,12,43%,21,2023/03/24
1733,896,,Dr.Trippa,+2,6,9,40%,15,2023/04/16
1734,896,,Skoon,+1,5,8,38%,13,2023/03/21
1735,896,,rlawodn40,-1,7,10,41%,17,2023/04/15
1736,895,,[eG] haumiblau7,-1,8,12,40%,20,2023/04/01
1737,895,,Fleececash,+3,7,9,44%,16,2023/03/29
1738,894,,Llamanade,-3,12,17,41%,29,2023/04/15
1739,894,,qxxs,-1,47,59,44%,106,2023/04/17
1740,894,,[FR]Unknown,-1,11,15,42%,26,2023/03/30
1741,894,,Paranoia,+1,6,9,40%,15,2023/03/25
1742,894,,Tiger Six One,+1,3,7,30%,10,2023/04/17
1743,894,,Tamylas,+1,3,8,27%,11,2023/04/09
1744,894,,Soruz,-1,6,12,33%,18,2023/04/13
1745,893,,成吉思汗,-2,6,9,40%,15,2023/03/29
1746,893,,DemYonkers,-1,5,9,36%,14,2023/04/15
1747,892,,mthrowaway,-3,7,12,37%,19,2023/04/02
1748,891,,Djerun,-2,7,14,33%,21,2023/04/04
1749,890,,TotalRudeboy,-2,4,7,36%,11,2023/04/04
1750,890,,Jason Bourne,-2,5,9,36%,14,2023/04/11
1751,890,,Mangus,-2,8,13,38%,21,2023/04/15
1752,890,,LITTLESUN,-1,3,7,30%,10,2023/04/17
1753,889,,Armyvetgaming,+5,38,47,45%,85,2023/03/27
1754,889,,CptNight00,-1,6,12,33%,18,2023/04/06
1755,889,,Wodan,-2,5,8,38%,13,2023/04/16
1756,888,,lanceaguirre1,-3,6,11,35%,17,2023/04/16
1757,888,,"Butts, Butts Everywhere",-2,10,13,43%,23,2023/04/16
1758,887,,Ben,+1,49,59,45%,108,2023/04/17
1759,887,,TwiddleCZ,+1,7,9,44%,16,2023/03/30
1760,887,,Superhoebo,-2,55,70,44%,125,2023/04/16
1761,887,,Union-Jack,-4,3,7,30%,10,2023/03/23
1762,886,,Kryptonos,-2,7,12,37%,19,2023/04/17
1763,886,,BERTAO,-1,7,13,35%,20,2023/04/16
1764,885,,WeLlaRd,-4,8,13,38%,21,2023/04/10
1765,885,,SteezyCamz,-2,10,13,43%,23,2023/03/22
1766,885,,Inż_Miszor,-1,6,10,38%,16,2023/03/29
1767,885,,justinespinal360,+1,58,76,43%,134,2023/04/17
1768,885,,Steve Irwin,-7,7,12,37%,19,2023/04/08
1769,884,,mool,-5,13,21,38%,34,2023/04/11
1770,883,,I_Shot_Yo_Daddy,-1,17,22,44%,39,2023/04/01
1771,883,,Mruae,-3,3,7,30%,10,2023/03/21
1772,882,,mlyczorz,+3,5,9,36%,14,2023/04/15
1773,880,,Dux,-6,55,65,46%,120,2023/04/17
1774,880,,Adamastor,+1,5,8,38%,13,2023/04/16
1775,880,,Watchtower II,-1,14,19,42%,33,2023/04/12
1776,880,,sebaschaos,-2,8,14,36%,22,2023/04/02
1777,879,,Spartansaint89,-1,8,11,42%,19,2023/04/13
1778,879,,JKimmawasp,-1,7,13,35%,20,2023/04/09
1779,879,,Bakayre,+1,39,55,41%,94,2023/03/31
1780,879,,pmak22,-7,13,26,33%,39,2023/04/14
1781,878,,Skinnyrat,-3,12,21,36%,33,2023/03/24
1782,877,,Winston Smith,-4,4,8,33%,12,2023/03/24
1783,877,,Juri,+2,32,57,36%,89,2023/04/12
1784,877,,tapesec,+2,24,27,47%,51,2023/04/17
1785,876,,BEANFUCK,-2,4,7,36%,11,2023/04/03
1786,876,,Eric,+1,8,13,38%,21,2023/04/12
1787,876,,MessiGOAT,-5,7,11,39%,18,2023/03/23
1788,876,,this51,-4,28,36,44%,64,2023/04/17
1789,875,,Curly Burns,-2,6,12,33%,18,2023/04/14
1790,874,,Moody,+1,7,12,37%,19,2023/04/17
1791,873,,k1036666,-2,4,9,31%,13,2023/04/15
1792,873,,Carven,-5,4,9,31%,13,2023/03/30
1793,873,,PeaceMountain,-1,4,8,33%,12,2023/04/01
1794,873,,Dolphin54,+2,4,8,33%,12,2023/04/15
1795,872,,Admiral Piett,-8,7,14,33%,21,2023/04/03
1796,872,,BRANDON,-3,3,8,27%,11,2023/04/14
1797,872,,(Y.G.) General Feraud,-2,6,10,38%,16,2023/04/07
1798,872,,Leroy Putty,-1,4,8,33%,12,2023/04/17
1799,871,,AUT_andi585,-2,8,13,38%,21,2023/04/14
1800,871,,dehuang,-2,5,9,36%,14,2023/03/25
1801,870,,Yunocrates,+5,22,31,42%,53,2023/04/14
1802,870,,JinkelaBoss,+1,3,7,30%,10,2023/03/29
1803,870,,2501885777,+3,15,24,38%,39,2023/04/17
1804,869,,DownloweD_DE,+2,14,18,44%,32,2023/03/26
1805,867,,Joey Zasa,-3,4,10,29%,14,2023/04/09
1806,866,,YYY_近战法师刘海柱,-2,14,18,44%,32,2023/04/17
1807,866,,luppy,-3,7,12,37%,19,2023/04/17
1808,866,,littleboots10,-4,4,9,31%,13,2023/04/03
1809,866,,猿夢,-3,5,10,33%,15,2023/04/16
1810,866,,406583006,+1,21,30,41%,51,2023/03/21
1811,865,,Doctor Gentle,-4,26,33,44%,59,2023/04/01
1812,864,,4u2nv,+4,28,37,43%,65,2023/04/16
1813,864,,Bobsuruncle,-1,22,29,43%,51,2023/04/16
1814,864,,Widukind,+1,2,8,20%,10,2023/04/16
1815,864,,MrGuyper,-3,3,7,30%,10,2023/03/31
1816,864,,BOOMERING,-1,4,8,33%,12,2023/03/31
1817,864,,winklewonka1.TTV,+1,35,41,46%,76,2023/04/02
1818,863,,Basjeseten,-3,6,11,35%,17,2023/04/09
1819,863,,thatguy1122,-2,3,8,27%,11,2023/04/18
1820,863,,goldngoy,+1,3,7,30%,10,2023/03/28
1821,863,,GoreDawn,+1,18,31,37%,49,2023/04/17
1822,863,,Jack The Stripper,+2,7,15,32%,22,2023/04/18
1823,862,,=UwG=Sharpshot007,-1,33,40,45%,73,2023/03/31
1824,862,,be4rd3d_s4murai,+1,39,44,47%,83,2023/04/18
1825,862,,eddrocks2,+1,3,7,30%,10,2023/04/07
1826,861,,Stereojet,+1,32,43,43%,75,2023/04/17
1827,861,,StalkerxX,-3,7,14,33%,21,2023/04/14
1828,861,,memes,-1,9,13,41%,22,2023/03/22
1829,861,,Garion,+1,5,9,36%,14,2023/04/16
1830,860,,jeffseasons,+1,12,20,38%,32,2023/04/07
1831,859,,nickevans973,+2,14,15,48%,29,2023/04/07
1832,859,,-SIBERIANWOLF-,-2,4,11,27%,15,2023/04/06
1833,859,,MEDDLE+FEEN,-3,8,14,36%,22,2023/04/18
1834,857,,Eat_Sleep_Dave_Repeat,+1,18,22,45%,40,2023/04/08
1835,857,,Cinoklu,-4,3,8,27%,11,2023/04/07
1836,857,,ajpriv,+3,11,15,42%,26,2023/04/17
1837,857,,tom-_-tom,-1,20,27,43%,47,2023/03/22
1838,857,,FasterRiver,-3,8,13,38%,21,2023/04/18
1839,856,,xShades,-5,61,78,44%,139,2023/04/08
1840,856,,wolfvut,-3,4,8,33%,12,2023/03/22
1841,854,,gamerguy298,-3,3,8,27%,11,2023/03/26
1842,854,,Maiti,-3,3,7,30%,10,2023/04/13
1843,854,,莣孓嗳,-2,4,7,36%,11,2023/04/02
1844,853,,Crippled Pigeon,-1,4,8,33%,12,2023/04/11
1845,852,,Riddick,-3,4,8,33%,12,2023/04/15
1846,851,,Ambone,+2,10,21,32%,31,2023/04/17
1847,850,,TOMAHAWK,-2,75,97,44%,172,2023/04/14
1848,850,,Kahveekit,+1,4,10,29%,14,2023/04/17
1849,850,,Blackman,-2,6,11,35%,17,2023/04/03
1850,849,,Ghost-link1,+2,10,20,33%,30,2023/03/29
1851,849,,Daddylonglegs86,-1,48,69,41%,117,2023/04/17
1852,849,,timezzzz,+1,8,14,36%,22,2023/03/23
1853,848,,CommandoNudel,-1,1,9,10%,10,2023/04/12
1854,848,,CYBORGOR,+1,5,10,33%,15,2023/03/22
1855,848,,[CL]OrkowyWudz,-2,4,10,29%,14,2023/04/12
1856,848,,Rallosdrake,-4,4,8,33%,12,2023/04/03
1857,846,,TJBR,-3,29,38,43%,67,2023/03/30
1858,846,,lewman215,+3,13,23,36%,36,2023/04/10
1859,846,,Adman29,-5,3,7,30%,10,2023/04/04
1860,846,,Hardrada,+1,33,44,43%,77,2023/04/16
1861,845,,Oph,-2,2,11,15%,13,2023/04/16
1862,845,,Buzzcore,-3,3,7,30%,10,2023/03/29
1863,845,,KyleHull_,+1,10,21,32%,31,2023/04/17
1864,845,,Buddhabear,+1,12,18,40%,30,2023/04/14
1865,844,,Seshino,+1,8,14,36%,22,2023/04/10
1866,844,,HawkslyTW,+1,7,14,33%,21,2023/04/17
1867,843,,sno^,-1,20,25,44%,45,2023/03/23
1868,842,,Monday,+2,11,17,39%,28,2023/04/08
1869,842,,keisan0518,+1,3,7,30%,10,2023/03/26
1870,842,,Dr. Colossus,-3,4,9,31%,13,2023/04/07
1871,842,,Ratham,-4,28,38,42%,66,2023/03/24
1872,841,,brahmasmi,+2,15,23,39%,38,2023/04/14
1873,841,,murlocmarine,+1,6,10,38%,16,2023/04/12
1874,841,,Hrungner,+2,10,15,40%,25,2023/04/12
1875,840,,Kernbohrer2000,-2,3,7,30%,10,2023/04/17
1876,840,,SigmaVulcan,-3,6,12,33%,18,2023/04/16
1877,840,,szwarc89,+1,3,8,27%,11,2023/04/17
1878,840,,fuzz,-3,21,31,40%,52,2023/04/17
1879,839,,Vapes 4 Christ,-5,6,12,33%,18,2023/04/06
1880,838,,Dermuden,-4,29,38,43%,67,2023/03/28
1881,838,,Ruthless Player,+1,30,38,44%,68,2023/04/17
1882,838,,colpin99,-2,7,14,33%,21,2023/04/10
1883,837,,Suby,-1,3,7,30%,10,2023/03/22
1884,837,,Hooper,+1,33,47,41%,80,2023/04/17
1885,837,,PirsJ,-1,2,8,20%,10,2023/04/06
1886,837,,Mr.X,-1,22,33,40%,55,2023/04/08
1887,837,,Darker Night,-3,22,25,47%,47,2023/03/29
1888,837,,Ackermann,-4,18,30,38%,48,2023/04/17
1889,836,,JediRapier,-2,9,16,36%,25,2023/04/14
1890,835,,DrakeRaids,+1,10,17,37%,27,2023/04/17
1891,835,,Dun,-3,5,11,31%,16,2023/04/16
1892,835,,AlbertJuanico,-4,5,11,31%,16,2023/03/27
1893,835,,pisopisooo,+2,21,31,40%,52,2023/04/06
1894,835,,ssss,-4,3,11,21%,14,2023/04/14
1895,834,,SoftcorE,-3,29,40,42%,69,2023/04/14
1896,833,,Andy,+1,4,9,31%,13,2023/04/13
1897,833,,MENTALLY ILL LIL SQUARE BUB,+1,4,10,29%,14,2023/04/14
1898,831,,Emmick,+3,6,12,33%,18,2023/04/17
1899,831,,darthbane2721,+1,8,14,36%,22,2023/04/17
1900,831,,AP,+2,10,20,33%,30,2023/04/16
1901,831,,zeroistheanswer,+1,7,14,33%,21,2023/04/10
1902,831,,iBrez,-6,50,68,42%,118,2023/04/17
1903,831,,Menace,-3,31,47,40%,78,2023/04/01
1904,830,,wazzup,-2,9,17,35%,26,2023/04/15
1905,829,,Gnasken,-1,7,16,30%,23,2023/04/17
1906,829,,Wardfish,-1,4,9,31%,13,2023/04/06
1907,829,,ARMENIAN94,-2,3,8,27%,11,2023/04/05
1908,828,,Sylver,+1,39,53,42%,92,2023/04/10
1909,828,,srubert83,-6,3,8,27%,11,2023/04/06
1910,828,,Bonebleeder,-2,10,17,37%,27,2023/04/11
1911,827,,Boom U Dead,-5,3,10,23%,13,2023/03/31
1912,827,,Jakub,-2,16,29,36%,45,2023/04/16
1913,827,,kiler47,-3,3,8,27%,11,2023/04/10
1914,827,,bOipuSsi AiNt gAE,+5,20,29,41%,49,2023/04/09
1915,825,,ComradeCosmos,-2,13,25,34%,38,2023/04/14
1916,824,,Judge_Dredd,+1,6,13,32%,19,2023/04/17
1917,824,,ARMAGEDDON_BETWEENER,-2,4,9,31%,13,2023/04/09
1918,823,,Civil,+2,18,29,38%,47,2023/04/15
1919,823,,sword_sweeper,-3,37,47,44%,84,2023/04/18
1920,822,,windonet,+1,20,33,38%,53,2023/04/15
1921,822,,大猩猩,-8,4,12,25%,16,2023/03/28
1922,822,,fakeplastictrunk,-1,4,10,29%,14,2023/04/14
1923,821,,czyzu,-1,37,51,42%,88,2023/04/07
1924,821,,KCDQ - floW,-5,2,9,18%,11,2023/04/04
1925,821,,Eriwin•Von•Sky.Kaiser,-1,26,37,41%,63,2023/03/24
1926,820,,hotte in space,+1,32,43,43%,75,2023/04/12
1927,819,,m0t0r,+1,8,14,36%,22,2023/03/31
1928,818,,El Patrón,+1,4,12,25%,16,2023/04/17
1929,818,,serps,-1,6,13,32%,19,2023/04/02
1930,818,,Killercrab1065,+1,6,12,33%,18,2023/04/08
1931,817,,syk900,-8,5,14,26%,19,2023/04/15
1932,817,,Sir_Lavender,-1,13,23,36%,36,2023/04/04
1933,817,,whothefock,+2,24,44,35%,68,2023/04/10
1934,817,,Brother,-2,18,32,36%,50,2023/04/09
1935,816,,571803985,-4,2,8,20%,10,2023/04/17
1936,815,,JohnFreda,-5,27,35,44%,62,2023/04/08
1937,815,,NoobHunter,-4,15,26,37%,41,2023/04/17
1938,815,,LOLwhat2,+2,4,9,31%,13,2023/04/08
1939,815,,the_blackrider,+4,7,15,32%,22,2023/04/17
1940,815,,maestroroma,-4,4,10,29%,14,2023/04/16
1941,815,,WoodROW,-3,4,6,40%,10,2023/03/30
1942,814,,Max_Ritter,-1,11,23,32%,34,2023/04/17
1943,812,,Maangas,+2,7,13,35%,20,2023/03/26
1944,812,,diango40,+1,23,35,40%,58,2023/04/12
1945,811,,Koiote,-1,5,14,26%,19,2023/04/15
1946,810,,要有多坚强丶才敢念念,-6,2,9,18%,11,2023/04/04
1947,809,,mschaneman,-1,8,16,33%,24,2023/04/15
1948,808,,Breemis,-3,8,18,31%,26,2023/03/22
1949,808,,leon-van-eijk,-8,3,12,20%,15,2023/04/14
1950,808,,dam8909,-2,6,15,29%,21,2023/04/07
1951,806,,KrispyK,+3,8,14,36%,22,2023/04/17
1952,805,,hicrew_187,-1,10,19,34%,29,2023/03/30
1953,805,,Haha666,-4,4,12,25%,16,2023/03/30
1954,804,,nicoleabeller,-4,13,30,30%,43,2023/04/16
1955,803,,twyk,-3,2,8,20%,10,2023/03/26
1956,802,,Wu Wei,+1,13,22,37%,35,2023/03/28
1957,801,,♠ Gauren ♠,+1,3,8,27%,11,2023/03/30
1958,798,,gloomycoin,-6,2,8,20%,10,2023/04/08
1959,798,,BluesTv,-1,40,73,35%,113,2023/04/15
1960,798,,不关橙猫猫的事,-2,4,10,29%,14,2023/04/09
1961,797,,1261944031,-2,39,64,38%,103,2023/04/05
1962,796,,dannybagz,+1,4,14,22%,18,2023/04/18
1963,796,,RTisan,+1,4,12,25%,16,2023/03/22
1964,795,,MickyMoose,-3,5,12,29%,17,2023/04/16
1965,795,,SaitoHawkeye,+1,3,8,27%,11,2023/04/16
1966,793,,brad123abc,-1,11,25,31%,36,2023/04/10
1967,793,,elhodel,-1,4,11,27%,15,2023/04/15
1968,793,,caxulito,+1,15,23,39%,38,2023/04/06
1969,792,,Goose8675309,-1,3,8,27%,11,2023/04/16
1970,791,,Jacob,+1,32,50,39%,82,2023/04/17
1971,790,,Parazit_CZ,-7,2,8,20%,10,2023/04/15
1972,789,,tewnclub,-5,4,11,27%,15,2023/04/12
1973,788,,2911321305,-2,2,8,20%,10,2023/03/26
1974,787,,Peppa Pig,+1,3,16,16%,19,2023/04/10
1975,787,,Soylent,-1,22,42,34%,64,2023/04/15
1976,785,,Hanseatic_Hazard,-3,4,10,29%,14,2023/04/04
1977,785,,bromar,-1,14,34,29%,48,2023/04/17
1978,783,,RobDisciple,-4,5,13,28%,18,2023/04/18
1979,782,,freeman248xz,-7,11,25,31%,36,2023/04/04
1980,782,,Death_dnb,-2,4,12,25%,16,2023/04/14
1981,780,,Freaky,+1,6,13,32%,19,2023/03/24
1982,780,,930328284,+2,4,10,29%,14,2023/04/10
1983,778,,Kharnage,-3,2,9,18%,11,2023/04/11
1984,777,,daibzer,-10,7,18,28%,25,2023/04/04
1985,777,,mr upprcut,-3,4,13,24%,17,2023/04/15
1986,777,,JetPlane,-1,6,15,29%,21,2023/04/02
1987,777,,Maleven,-9,25,43,37%,68,2023/04/17
1988,776,,connor18,-4,18,32,36%,50,2023/04/09
1989,773,,Nessman59,+1,12,27,31%,39,2023/04/16
1990,773,,Jayu,-1,2,9,18%,11,2023/03/26
1991,773,,SoonBro,-2,4,12,25%,16,2023/04/14
1992,772,,Nanashi,-2,7,16,30%,23,2023/04/17
1993,771,,Noot Noot,-2,6,18,25%,24,2023/04/10
1994,770,,MIDO,-3,4,10,29%,14,2023/03/31
1995,770,,UnfundedKarma,-5,4,12,25%,16,2023/03/30
1996,768,,CaptnHambre,-6,2,9,18%,11,2023/04/15
1997,768,,HeyItsDad,-3,2,8,20%,10,2023/04/06
1998,768,,fapvan,+2,12,24,33%,36,2023/04/16
1999,768,,vdroop,-3,14,28,33%,42,2023/04/18
2000,768,,ZIZI.NarineMollE,-3,5,12,29%,17,2023/04/02
2001,767,,Bosarris,-2,5,13,28%,18,2023/04/15
2002,767,,csiga,+1,2,8,20%,10,2023/04/03
2003,766,,Draug,-7,2,9,18%,11,2023/04/17
2004,764,,MaSteR_ZaiN87,-5,2,11,15%,13,2023/03/28
2005,764,,hannibal,-5,3,11,21%,14,2023/04/02
2006,761,,Lukyel,-1,6,16,27%,22,2023/04/13
2007,760,,BLADE0402,-1,5,12,29%,17,2023/03/28
2008,760,,marano5492,+1,2,9,18%,11,2023/03/27
2009,759,,blindheimole,-3,5,14,26%,19,2023/04/12
2010,758,,marijuana,-1,5,14,26%,19,2023/04/17
2011,758,,ARO,-5,25,49,34%,74,2023/04/12
2012,758,,KING,+9,10,17,37%,27,2023/04/09
2013,758,,fOo,+1,26,54,33%,80,2023/04/17
2014,757,,VenomusV,-9,1,10,9%,11,2023/04/17
2015,756,,z.iec53,-5,3,14,18%,17,2023/04/12
2016,755,,Thundercliese,-5,3,11,21%,14,2023/04/10
2017,755,,Portugais,-3,3,10,23%,13,2023/04/05
2018,752,,Charon,-2,3,10,23%,13,2023/04/11
2019,751,,kundernietsvan,-3,2,9,18%,11,2023/04/05
2020,750,,lbtym8311,+1,5,15,25%,20,2023/04/02
2021,748,,skalf,-6,3,12,20%,15,2023/04/16
2022,747,,ThcAS81,-4,20,46,30%,66,2023/04/16
2023,745,,daviaud_rod,-3,8,20,29%,28,2023/04/15
2024,744,,SuperJan91,-2,5,13,28%,18,2023/04/17
2025,743,,304532544,-2,2,10,17%,12,2023/04/01
2026,739,,Wolfstorm,-6,1,9,10%,10,2023/04/17
2027,738,,Max,-1,8,23,26%,31,2023/04/17
2028,738,,ajlanner,+1,11,31,26%,42,2023/04/15
2029,737,,Mišák Moravan.,-7,2,10,17%,12,2023/04/05
2030,735,,lvaces,+1,73,156,32%,229,2023/04/08
2031,734,,McBlaster,-1,9,24,27%,33,2023/03/31
2032,733,,no.,-2,1,9,10%,10,2023/04/02
2033,732,,〔防弹小熊〕,-5,4,17,19%,21,2023/04/10
2034,730,,Imam lud da sam papir™,-3,20,35,36%,55,2023/03/30
2035,729,,The Book of Mormon is true,+1,1,10,9%,11,2023/04/15
2036,727,,kaka890619,+2,32,74,30%,106,2023/04/06
2037,726,,Roy of the Rovers,-5,3,15,17%,18,2023/04/17
2038,724,,Veeh Youtube,-4,22,43,34%,65,2023/04/16
2039,719,,christus99,-8,1,10,9%,11,2023/04/17
2040,719,,Towmater683,-6,2,13,13%,15,2023/04/11
2041,710,,LoneWolf88,-10,1,10,9%,11,2023/04/11
2042,710,,ggusakan,-10,0,10,0%,10,2023/04/13
2043,709,,F4lc!,-2,6,18,25%,24,2023/03/26
2044,707,,我带你们打游戏,-2,1,11,8%,12,2023/04/15
2045,706,,Diamond Hands,-7,1,10,9%,11,2023/04/17
2046,701,,SUPERB!!,-2,2,12,14%,14,2023/04/02
2047,696,,pbricks.com,-8,24,47,34%,71,2023/03/22
2048,695,,S0N 0F N0THING,-11,5,23,18%,28,2023/04/08
2049,694,,一萬場辛烷十萬管興奮劑也追不到你的心,-1,1,13,7%,14,2023/04/11
2050,693,,Awesomefusion,+2,24,80,23%,104,2023/04/10
2051,692,,TruBBeld,-8,2,10,17%,12,2023/03/29
2052,691,,Lunchbox,+2,2,13,13%,15,2023/04/15
2053,689,,matigol72,-13,1,15,6%,16,2023/04/04
2054,685,,Spontaneous,-10,6,26,19%,32,2023/04/09
2055,683,,DaddyCobra,-2,8,25,24%,33,2023/04/16
2056,683,,TomClats,-11,13,36,27%,49,2023/04/12
2057,683,,username_player,-6,4,21,16%,25,2023/04/09
2058,676,,nathanjeyhani,-2,2,11,15%,13,2023/04/14
2059,673,,SirOwnsAlot,-11,4,25,14%,29,2023/04/03
2060,672,,nickwideman,-6,7,23,23%,30,2023/03/29
2061,671,,LoneRaider,-5,26,64,29%,90,2023/04/16
2062,668,,MrTeej2,-2,8,36,18%,44,2023/04/17
2063,666,,Happer11,-4,3,23,12%,26,2023/03/31
2064,664,,lukkan,-16,0,16,0%,16,2023/04/17
2065,660,,Shunkiz *TanKKK*,-7,2,13,13%,15,2023/04/10
2066,659,,NasikaXO,-12,0,12,0%,12,2023/04/02
2067,657,,HB_JOSH,-10,0,10,0%,10,2023/03/25
2068,654,,Mountainman,-2,18,52,26%,70,2023/04/13
2069,648,,pdkennedy,-1,6,25,19%,31,2023/03/31
2070,646,,Eli,-10,8,35,19%,43,2023/04/17
2071,646,,Canix_FPV,-10,0,10,0%,10,2023/04/16
2072,641,,2442403926,-3,5,23,18%,28,2023/04/16
2073,639,,Montgomery,-4,3,13,19%,16,2023/04/09
2074,637,,Rabiath,-7,3,28,10%,31,2023/03/22
2075,635,,[MG] BulletDispenser,-1,3,15,17%,18,2023/03/29
2076,632,,iBucNasty,-8,8,36,18%,44,2023/03/29
2077,632,,The Atropian,+1,4,24,14%,28,2023/04/15
2078,632,,<-- Jehuty,-2,2,18,10%,20,2023/04/12
2079,626,,Hybridizer,-8,5,24,17%,29,2023/04/17
2080,615,,capitaine.Nemo,-11,0,11,0%,11,2023/04/15
2081,591,,1 shoot 1 kill,-14,0,14,0%,14,2023/04/12
2082,591,,clackcalven,-2,8,38,17%,46,2023/04/16
2083,569,,爱念痛,-3,26,109,19%,135,2023/04/17
2084,557,,0903bear850170,-10,1,27,4%,28,2023/04/11
2085,555,,Time4ABrew,-5,26,68,28%,94,2023/04/17
2086,545,,778708221,-4,4,42,9%,46,2023/04/11
2087,521,,守猎者01,-13,3,31,9%,34,2023/04/11
2088,521,,FuzzyDunlop81,-18,9,57,14%,66,2023/04/04
2089,503,,tobias.krueger230999,-3,12,100,11%,112,2023/04/16
