RANK,ELO,LEVEL,ALIAS,STREAK,WINS,LOSSES,RATIO,TOTAL,LAST GAME
1,1752,,Amita,+2,96,14,87%,110,2023/04/17
2,1719,,Orangepest,+5,102,14,88%,116,2023/04/16
3,1719,,Mickey,+22,88,19,82%,107,2023/04/01
4,1686,,havoc,+10,157,49,76%,206,2023/04/17
5,1682,,Jibber,+2,108,26,81%,134,2023/04/07
6,1656,,xiaomo,+17,85,28,75%,113,2023/04/17
7,1654,,Frontyard man,+23,118,38,76%,156,2023/03/28
8,1643,,[Peanut] Calyon,+8,198,62,76%,260,2023/04/17
9,1636,,S205,+22,117,34,77%,151,2023/04/17
10,1617,,xFidde,+1,57,11,84%,68,2023/04/13
11,1610,,Charlotte,+20,190,107,64%,297,2023/04/17
12,1606,,[L2P]BartonPL,+10,68,19,78%,87,2023/04/01
13,1588,,you can count on osttruppen!,+5,112,32,78%,144,2023/04/16
14,1587,,Nicko,+17,37,5,88%,42,2023/04/13
15,1571,,elpern,+4,52,10,84%,62,2023/04/14
16,1560,,渣渣，反了他，偶不艹了你爸，气死偶嘞！！,+1,413,215,66%,628,2023/04/15
17,1543,,Treadz,+7,161,64,72%,225,2023/04/17
18,1541,,DumaisTV,-2,110,39,74%,149,2023/04/07
19,1534,,Aimstrong,-2,62,32,66%,94,2023/04/12
20,1528,,Jesus is My Saviour,+2,32,3,91%,35,2023/04/16
21,1526,,Rei,+12,56,18,76%,74,2023/03/31
22,1521,,F3riG,-1,18,2,90%,20,2023/04/09
23,1519,,Dumme Katze,+2,80,26,75%,106,2023/04/16
24,1515,,Backyard man,+8,95,44,68%,139,2023/04/16
25,1510,,Rod,+3,126,51,71%,177,2023/04/15
26,1510,,IncaUna,+6,38,8,83%,46,2023/04/09
27,1505,,Sovereign,+16,73,25,74%,98,2023/04/16
28,1502,,HelpingHans,+4,45,11,80%,56,2023/04/04
29,1494,,Theodosios,+8,22,1,96%,23,2023/04/07
30,1492,,MajorKusaetNogi,+1,59,24,71%,83,2023/04/05
31,1486,,Happycat,+9,31,5,86%,36,2023/04/17
32,1483,,Basset,-1,78,38,67%,116,2023/04/11
33,1481,,momo4sho,+4,33,8,80%,41,2023/04/10
34,1480,,The Sloth,+1,25,5,83%,30,2023/04/05
35,1477,,[Peanut] Caosak,-2,30,8,79%,38,2023/04/03
36,1469,,IntegralSweeD,+1,44,17,72%,61,2023/04/02
37,1467,,tagilla,-1,80,46,63%,126,2023/04/15
38,1465,,JiuMi,+5,48,21,70%,69,2023/04/07
39,1465,,The Angry Dutchman,+1,43,20,68%,63,2023/04/17
40,1453,,Joel,-1,207,149,58%,356,2023/04/15
41,1446,,M0nItor,+2,44,18,71%,62,2023/04/18
42,1445,,Siberian,+8,71,34,68%,105,2023/04/16
43,1445,,FBI OPEN UP,+3,202,106,66%,308,2023/04/17
44,1441,,salmonTA,+3,29,12,71%,41,2023/04/12
45,1440,,Kyeon-woo,-2,132,94,58%,226,2023/04/04
46,1436,,CptLink( jimmy),+10,38,14,73%,52,2023/04/01
47,1429,,Zenabauer,+4,35,14,71%,49,2023/03/31
48,1428,,LemonMint,+3,33,12,73%,45,2023/04/09
49,1427,,Trainzz,+1,67,38,64%,105,2023/04/17
50,1427,,IntegralWojtek,-1,111,59,65%,170,2023/03/28
51,1424,,Panzergrenadierangreifer,+3,17,6,74%,23,2023/04/16
52,1424,,BaByuByu,+5,61,28,69%,89,2023/04/14
53,1424,,Imbbe,-1,40,14,74%,54,2023/04/15
54,1423,,nub,+1,87,39,69%,126,2023/04/17
55,1422,,MP_HappyPanther,+2,25,14,64%,39,2023/04/09
56,1421,,PanzerGrenadier,+5,90,63,59%,153,2023/04/10
57,1420,,WouldULike2BeAPepper2?,+1,109,70,61%,179,2023/04/12
58,1420,,Hing-gi,-1,298,217,58%,515,2023/04/10
59,1419,,TarNationZ,+4,20,4,83%,24,2023/04/01
60,1416,,TRI1091,-1,24,9,73%,33,2023/04/10
61,1415,,今夜薄雾,+10,14,1,93%,15,2023/04/08
62,1414,,Farlion,+5,39,14,74%,53,2023/04/15
63,1413,,Simplify,+2,19,4,83%,23,2023/04/10
64,1407,,Jae,+1,64,29,69%,93,2023/04/09
65,1406,,sheenhochul,+4,120,88,58%,208,2023/04/17
66,1405,,DarkAlric,+11,66,32,67%,98,2023/04/17
67,1404,,W00tLeLBrrrrrrrrrrrrrr,+10,53,23,70%,76,2023/04/16
68,1402,,lattouf,+6,35,18,66%,53,2023/04/18
69,1400,,Ra11,+3,16,2,89%,18,2023/04/03
70,1400,,Estocade Gaming YT,+2,47,16,75%,63,2023/03/26
71,1400,,Ghost,+2,51,30,63%,81,2023/03/25
72,1398,,Niklas,+1,13,2,87%,15,2023/04/06
73,1398,,vegetabledoge,+1,53,29,65%,82,2023/04/12
74,1392,,Finndeed,-1,27,9,75%,36,2023/03/24
75,1391,,Begbie,+2,66,37,64%,103,2023/04/10
76,1391,,Vector,+5,34,12,74%,46,2023/04/17
77,1389,,Miguel,+3,10,1,91%,11,2023/04/16
78,1389,,vwvc,+11,27,10,73%,37,2023/04/14
79,1387,,포스트정윤종,+6,28,7,80%,35,2023/04/05
80,1382,,Hallelujah,-1,77,24,76%,101,2023/04/17
81,1382,,Zyswen,+1,49,20,71%,69,2023/04/05
82,1381,,Walther,+10,10,0,100%,10,2023/04/08
83,1379,,U SUCK,+9,51,22,70%,73,2023/03/23
84,1378,,hhjjjjjj,+9,100,68,60%,168,2023/04/17
85,1376,,OMGPOP!,+3,29,11,73%,40,2023/04/08
86,1375,,PutPut - AusarTheVile,+1,44,21,68%,65,2023/04/15
87,1374,,Faad3e_,+1,9,1,90%,10,2023/04/13
88,1374,,Luckeeey,+4,93,58,62%,151,2023/04/15
89,1374,,悲伤淹没了你,+2,57,32,64%,89,2023/04/06
90,1374,,TheChosen,+8,48,25,66%,73,2023/03/25
91,1371,,Logys P,+6,37,15,71%,52,2023/04/05
92,1370,,Luvnest,-1,23,9,72%,32,2023/04/17
93,1370,,lePepsi,-1,25,12,68%,37,2023/03/23
94,1369,,Stevanevus,+1,16,4,80%,20,2023/04/07
95,1367,,Equuz,+1,44,17,72%,61,2023/04/17
96,1363,,JZuna,+4,19,6,76%,25,2023/03/30
97,1362,,Vesat Eiwalter,-2,133,74,64%,207,2023/04/09
98,1360,,T.R. 3nder,+1,24,8,75%,32,2023/04/07
99,1359,,DexN,+2,49,30,62%,79,2023/04/15
100,1358,,RTHabibty,+1,255,212,55%,467,2023/04/16
101,1358,,The101stAirBorne,+4,68,40,63%,108,2023/04/15
102,1358,,*Mule,+2,13,2,87%,15,2023/04/08
103,1356,,Kamikaze Scotsman,+6,39,19,67%,58,2023/03/30
104,1355,,Vosi-K,+3,164,139,54%,303,2023/04/17
105,1354,,Clororaa,+2,12,2,86%,14,2023/03/29
106,1354,,幽灵,-1,61,43,59%,104,2023/04/11
107,1354,,Vector,-3,39,20,66%,59,2023/04/12
108,1353,,nystrom,+7,12,2,86%,14,2023/04/18
109,1351,,AceHiro,+6,38,23,62%,61,2023/04/05
110,1350,,Imperial Dane,+1,37,23,62%,60,2023/04/16
111,1350,,隆美尔的马戏团,+2,64,36,64%,100,2023/04/10
112,1350,,Pat Sajack Headlock,-1,73,45,62%,118,2023/04/08
113,1349,,Jokren,+1,13,4,76%,17,2023/03/27
114,1347,,VonManteuffel,-1,21,6,78%,27,2023/04/14
115,1343,,Jelly Bean,-2,23,8,74%,31,2023/03/26
116,1343,,Shut up and buy some skins!,-1,14,5,74%,19,2023/04/01
117,1341,,Erebys,-2,111,89,56%,200,2023/03/30
118,1337,,are,+2,120,79,60%,199,2023/04/17
119,1337,,VulcanHDGaming No.1 Fan,-3,92,58,61%,150,2023/04/14
120,1337,,SLush,+1,209,149,58%,358,2023/04/04
121,1336,,Herr Blautier,+2,66,46,59%,112,2023/04/14
122,1335,,-NSO- Hon3ynuts,+6,11,1,92%,12,2023/03/31
123,1333,,BarelyPlaying,+5,36,21,63%,57,2023/04/16
124,1333,,Dr. Jekyll,+3,16,6,73%,22,2023/04/03
125,1333,,Inverse,-1,35,15,70%,50,2023/04/17
126,1332,,m0ek,+4,28,17,62%,45,2023/03/24
127,1332,,Bames Nond Having A Stronk,+1,66,44,60%,110,2023/04/17
128,1330,,ohmygod321,+5,36,18,67%,54,2023/04/03
129,1330,,Sunny,+5,11,1,92%,12,2023/04/11
130,1328,,SKT,+3,14,4,78%,18,2023/04/13
131,1328,,DarthPotato,+5,57,39,59%,96,2023/04/14
132,1328,,Enemy,-2,57,36,61%,93,2023/04/18
133,1328,,GentleFox,-1,24,12,67%,36,2023/04/16
134,1327,,whynot,+1,63,39,62%,102,2023/04/17
135,1327,,Dunkerque,-1,20,4,83%,24,2023/04/14
136,1327,,Gagzuull,+1,9,1,90%,10,2023/03/26
137,1326,,himynameisho,+3,10,1,91%,11,2023/04/08
138,1326,,ciamgyic,-1,58,37,61%,95,2023/04/14
139,1326,,LaDin2,+2,26,8,76%,34,2023/04/17
140,1325,,°NOSMarkov.-,+1,48,32,60%,80,2023/04/07
141,1325,,Potato slicer,+5,36,17,68%,53,2023/03/28
142,1324,,Mordo47,+6,9,1,90%,10,2023/03/29
143,1324,,CoH2 sucks,+2,40,26,61%,66,2023/04/15
144,1324,,Jimbob2121,+7,37,23,62%,60,2023/04/09
145,1323,,Hybris,+3,23,8,74%,31,2023/04/07
146,1322,,Jünker,+1,40,26,61%,66,2023/04/17
147,1321,,Tiefflieger,-1,57,33,63%,90,2023/04/13
148,1321,,Scio,+3,24,12,67%,36,2023/03/25
149,1320,,suomenpaskin,+1,50,27,65%,77,2023/04/04
150,1320,,Kamfrenchie,+4,28,13,68%,41,2023/04/17
151,1320,,digdigdig,+1,123,103,54%,226,2023/04/17
152,1319,,[GCDC]RwiAng,-3,18,10,64%,28,2023/03/26
153,1319,,Pete Weber,+5,10,1,91%,11,2023/03/29
154,1319,,Refero,-1,12,4,75%,16,2023/04/13
155,1319,,[DeanOfBao]hokkskyc,-4,31,14,69%,45,2023/03/24
156,1317,,bigfriendlybert,-3,21,7,75%,28,2023/03/23
157,1316,,Snoopa,+1,55,35,61%,90,2023/04/07
158,1315,,Twitch Yunicone≠≠Pony,+7,74,45,62%,119,2023/04/18
159,1315,,Okeyeg,-3,27,16,63%,43,2023/04/09
160,1315,,Tassos117,+3,24,11,69%,35,2023/04/10
161,1314,,Lyco,+3,18,7,72%,25,2023/04/18
162,1314,,DanielD,-2,14,4,78%,18,2023/04/17
163,1313,,SIMONK,-2,106,70,60%,176,2023/04/16
164,1313,,Kido,+1,51,39,57%,90,2023/04/11
165,1313,,炮击,-1,14,5,74%,19,2023/04/11
166,1312,,(✺ω✺)chupacabra,+7,19,8,70%,27,2023/04/08
167,1311,,McTerran,+4,181,138,57%,319,2023/04/17
168,1310,,Dugo,+1,9,1,90%,10,2023/04/16
169,1310,,Lt Beren,-4,67,39,63%,106,2023/04/08
170,1310,,Toiletguy,-2,72,44,62%,116,2023/04/18
171,1310,,[BPX] Cactlosio,+6,12,2,86%,14,2023/04/13
172,1308,,loovus,+2,66,42,61%,108,2023/04/17
173,1307,,[EPIC]gogy,+4,19,5,79%,24,2023/04/14
174,1306,,Make a wish™ |,-1,53,35,60%,88,2023/04/15
175,1306,,LENS,-2,42,26,62%,68,2023/04/08
176,1306,,Battlemeister,-1,15,5,75%,20,2023/04/14
177,1305,,Lardt,+1,44,33,57%,77,2023/04/17
178,1304,,Blafreak,+4,10,1,91%,11,2023/04/06
179,1301,,kekadam,+3,21,8,72%,29,2023/03/29
180,1301,,Azakura,+3,56,36,61%,92,2023/04/16
181,1300,,Slyzor,-1,98,75,57%,173,2023/04/12
182,1298,,BiliBilI_23984226_Luckyman55,-1,8,2,80%,10,2023/04/09
183,1298,,Deep♂Dark♂Fantasy,+1,27,15,64%,42,2023/04/17
184,1298,,Pony by Nature,+2,20,11,65%,31,2023/04/17
185,1291,,K. Ronaldo,-1,26,12,68%,38,2023/03/31
186,1291,,WordBearers[Borgore],-1,38,27,58%,65,2023/04/15
187,1289,,Stark,-1,17,8,68%,25,2023/04/08
188,1289,,ChuaMC,-2,41,28,59%,69,2023/04/14
189,1286,,X1Alpha2,+1,8,2,80%,10,2023/04/17
190,1285,,E-zy,-2,19,8,70%,27,2023/04/08
191,1285,,SexPistole,+3,43,29,60%,72,2023/04/12
192,1285,,Dezman,+2,15,6,71%,21,2023/04/13
193,1283,,KEI,+4,36,22,62%,58,2023/04/06
194,1283,,sakuya,+4,12,6,67%,18,2023/03/31
195,1280,,Auto Man,+8,8,2,80%,10,2023/03/25
196,1280,,alienman,-1,30,14,68%,44,2023/04/14
197,1279,,Hanwoomul,+1,17,7,71%,24,2023/04/17
198,1278,,PaniC-.-,+2,15,5,75%,20,2023/04/07
199,1278,,Faramir,+1,51,30,63%,81,2023/04/15
200,1278,,KyrreLubiWodę,-1,14,6,70%,20,2023/03/26
201,1277,,Enterprise Ω,-1,25,14,64%,39,2023/04/17
202,1277,,cat tank,+9,22,9,71%,31,2023/04/14
203,1276,,Altrersyr,-2,19,8,70%,27,2023/04/10
204,1276,,FuzZiioN,-1,31,17,65%,48,2023/04/16
205,1276,,Aim_Deusi,+4,17,7,71%,24,2023/03/27
206,1274,,AoE rage,-1,185,161,53%,346,2023/04/18
207,1272,,night_raven0203,-1,20,13,61%,33,2023/04/11
208,1272,,TimFranks,-1,21,7,75%,28,2023/03/29
209,1271,,Mr. Bepsi,+10,22,8,73%,30,2023/04/02
210,1270,,fenerx,-1,26,19,58%,45,2023/03/26
211,1270,,RyuJou,+2,16,9,64%,25,2023/03/30
212,1270,,Rolling9Deep,-1,36,18,67%,54,2023/03/29
213,1269,,akutoku,+1,19,11,63%,30,2023/04/17
214,1269,,Laughing Sun,+3,13,6,68%,19,2023/03/27
215,1269,,Bad Ash,+8,16,6,73%,22,2023/03/21
216,1267,,Nostalgia93',+2,19,9,68%,28,2023/04/16
217,1267,,Rasler63,+3,41,27,60%,68,2023/03/27
218,1267,,MONKEY,+3,8,2,80%,10,2023/04/02
219,1266,,Dim Hoff Mouth Breather LOL,+1,20,11,65%,31,2023/03/30
220,1265,,Yoyapp,-1,13,6,68%,19,2023/04/12
221,1265,,ihatealex,+1,11,5,69%,16,2023/03/24
222,1264,,longyouaak,+1,212,154,58%,366,2023/04/17
223,1264,,gilashley,+2,28,14,67%,42,2023/04/12
224,1263,,REDFORCE,-5,15,9,63%,24,2023/03/31
225,1263,,Noob Nath,+1,53,35,60%,88,2023/04/16
226,1263,,Ding Dong,+2,66,51,56%,117,2023/04/16
227,1263,,fiadaputa,-1,41,25,62%,66,2023/04/15
228,1262,,>Cow<,+1,29,18,62%,47,2023/04/06
229,1262,,mikec_81,-2,166,141,54%,307,2023/04/14
230,1262,,miyanishi,+1,78,61,56%,139,2023/04/01
231,1261,,Otvor,+1,51,39,57%,90,2023/04/10
232,1261,,Deliri0us,+1,12,4,75%,16,2023/04/17
233,1261,,Leorique,+5,73,56,57%,129,2023/04/01
234,1259,,Makros,+9,10,2,83%,12,2023/03/27
235,1259,,Rutherford B. Hayes,-2,59,40,60%,99,2023/04/07
236,1259,,dumle,+3,10,3,77%,13,2023/03/25
237,1258,,hireling,+1,8,2,80%,10,2023/03/23
238,1257,,Penetron2000,-1,23,16,59%,39,2023/04/16
239,1256,,Mr. Fahrenheit,+3,33,18,65%,51,2023/03/31
240,1256,,Airandfelt,+2,16,7,70%,23,2023/04/16
241,1256,,wily wilbert,-3,41,26,61%,67,2023/03/31
242,1255,,53Zmirko,-1,9,3,75%,12,2023/03/30
243,1255,,Exerate,-1,17,8,68%,25,2023/04/11
244,1254,,Cheezus,+9,50,40,56%,90,2023/04/01
245,1254,,FK9DD,+3,39,29,57%,68,2023/04/07
246,1253,,GluteusMaximus,+5,10,2,83%,12,2023/04/07
247,1252,,JoseyWales_,+1,95,71,57%,166,2023/04/01
248,1252,,LEV-Detahaven,+2,53,36,60%,89,2023/04/09
249,1251,,🐼🐼Kashll🐼🐼,-3,30,26,54%,56,2023/04/02
250,1251,,Satan2,+2,61,50,55%,111,2023/04/17
251,1250,,Reakly,-1,43,27,61%,70,2023/04/16
252,1249,,BALCK_9,+5,28,18,61%,46,2023/04/14
253,1248,,Gnorri,-1,18,9,67%,27,2023/04/06
254,1248,,Quack,+3,10,2,83%,12,2023/04/14
255,1247,,Jay,-1,32,22,59%,54,2023/04/09
256,1246,,Anilasabyss,+2,17,11,61%,28,2023/04/16
257,1245,,Sonnenschein,-3,20,14,59%,34,2023/03/30
258,1245,,RepoRogue,-1,15,7,68%,22,2023/04/02
259,1245,,PunisHer1638,-2,22,16,58%,38,2023/04/13
260,1245,,Noah,-2,9,3,75%,12,2023/04/02
261,1245,,Uesugi,+1,10,3,77%,13,2023/03/23
262,1244,,The Face of Autism,+1,20,12,63%,32,2023/04/16
263,1244,,SiegMundJoe,+1,17,10,63%,27,2023/04/16
264,1244,,Boomgoesthedynamite,-1,55,36,60%,91,2023/04/16
265,1242,,Thrawn,-1,10,4,71%,14,2023/04/04
266,1242,,Mister Ju-Ju,+1,33,22,60%,55,2023/04/16
267,1241,,GBPirate,-1,9,3,75%,12,2023/04/10
268,1238,,~SB 真多~,-1,156,132,54%,288,2023/04/14
269,1237,,Kwarzym,-1,13,5,72%,18,2023/04/16
270,1237,,Bernulf von Greifenstein,+1,24,16,60%,40,2023/04/02
271,1237,,Kaduin,+2,21,14,60%,35,2023/04/08
272,1237,,BiliBilI_24073386_狐狸,+3,15,6,71%,21,2023/04/17
273,1237,,Pie-Eater,-4,13,7,65%,20,2023/03/29
274,1235,,^1Soldat^0James,+1,32,20,62%,52,2023/04/16
275,1235,,Player 4,+2,17,10,63%,27,2023/04/12
276,1235,,folder,+3,90,87,51%,177,2023/04/06
277,1234,,Turin,+1,13,6,68%,19,2023/03/25
278,1234,,SuperKeitel,+2,64,44,59%,108,2023/04/17
279,1232,,BananaInPajamas,-1,32,23,58%,55,2023/04/15
280,1232,,DD響,+5,16,7,70%,23,2023/03/29
281,1232,,Ghaell,-2,21,16,57%,37,2023/03/25
282,1231,,suzune[JP],-3,17,13,57%,30,2023/03/25
283,1230,,lush_meadow,+3,10,4,71%,14,2023/04/15
284,1229,,HighFive,+1,47,40,54%,87,2023/04/17
285,1229,,aSIISymbiosis,+1,10,3,77%,13,2023/04/17
286,1229,,Esxile,+5,61,53,54%,114,2023/03/30
287,1229,,normad,+1,25,18,58%,43,2023/04/15
288,1229,,PaperPadding,-1,27,17,61%,44,2023/04/10
289,1228,,ChocolateStarfish,+13,19,7,73%,26,2023/04/05
290,1228,,tightrope,-2,22,14,61%,36,2023/04/12
291,1228,,Prostenal,-1,38,25,60%,63,2023/03/30
292,1228,,Elisabeth Eugenie,+1,36,23,61%,59,2023/04/09
293,1227,,[CuCh] The-Pope,-1,17,11,61%,28,2023/04/15
294,1227,,I Find A Computer Indispensable,-1,46,31,60%,77,2023/04/09
295,1227,,Synthsere,-2,24,14,63%,38,2023/04/14
296,1227,,Wasack,-1,52,41,56%,93,2023/04/04
297,1226,,TwistedTootsy,-2,30,19,61%,49,2023/03/29
298,1226,,OHxYEAHxJNP,+2,25,12,68%,37,2023/04/16
299,1225,,Cular13,+3,36,24,60%,60,2023/04/13
300,1225,,wolf_tank,+2,52,40,57%,92,2023/03/31
301,1224,,Fuel Enjoyer,+5,10,3,77%,13,2023/04/08
302,1224,,butterfingers158,+1,7,3,70%,10,2023/04/07
303,1223,,RRREEEIII,-1,83,75,53%,158,2023/04/17
304,1223,,Mercury Blaze,-1,9,4,69%,13,2023/04/10
305,1222,,Vaits,-2,8,4,67%,12,2023/03/31
306,1222,,Apoptosis,+6,11,4,73%,15,2023/04/12
307,1221,,Harold H,-2,33,23,59%,56,2023/04/14
308,1221,,Fortune,+4,20,10,67%,30,2023/03/27
309,1220,,Colonel0tto,-1,44,29,60%,73,2023/04/15
310,1220,,[KSG] Blackwing,-2,13,6,68%,19,2023/04/08
311,1220,,RTX4090,+1,10,4,71%,14,2023/03/26
312,1220,,Dilophosaur,+7,21,9,70%,30,2023/04/04
313,1219,,Koenig,+4,85,70,55%,155,2023/04/18
314,1219,,Vateusz,-3,16,9,64%,25,2023/04/17
315,1218,,Raptorjesus,-2,36,24,60%,60,2023/04/08
316,1217,,Aerohank,+2,8,3,73%,11,2023/04/10
317,1217,,icanseeu...,+1,29,24,55%,53,2023/04/13
318,1216,,Whale,+2,12,6,67%,18,2023/04/03
319,1216,,Guziol#,-1,15,7,68%,22,2023/04/09
320,1215,,FischerOnTour,+5,10,4,71%,14,2023/04/13
321,1215,,cћk247,+3,10,5,67%,15,2023/03/23
322,1215,,CPU-Easy,+4,26,17,60%,43,2023/03/26
323,1215,,Kayaking Koala,-3,29,18,62%,47,2023/03/30
324,1214,,dbsights,+3,29,15,66%,44,2023/04/02
325,1214,,Panzy Spliter,-1,76,58,57%,134,2023/04/17
326,1214,,TankinatorXD,+2,32,24,57%,56,2023/04/15
327,1213,,Commander_Utus,+1,12,6,67%,18,2023/03/27
328,1213,,juan.aldava,+3,22,17,56%,39,2023/03/26
329,1213,,Chiico,+2,18,9,67%,27,2023/04/07
330,1212,,type97tiha,-1,16,9,64%,25,2023/04/04
331,1212,,Archangel Michael,-5,81,67,55%,148,2023/04/02
332,1212,,DiddlyHole,+1,10,3,77%,13,2023/04/14
333,1211,,Juggermarc,-1,51,34,60%,85,2023/04/12
334,1211,,Devrye,+2,12,5,71%,17,2023/04/13
335,1211,,Redhorrn,+2,21,13,62%,34,2023/04/05
336,1210,,loleg,+1,8,3,73%,11,2023/04/16
337,1210,,aBurningDog,+4,20,14,59%,34,2023/04/07
338,1210,,ceramicrooster,+1,73,60,55%,133,2023/04/17
339,1210,,Legende,+3,21,20,51%,41,2023/04/10
340,1210,,Dullahan,+2,72,54,57%,126,2023/04/15
341,1209,,GeeNo,+4,18,10,64%,28,2023/04/16
342,1208,,DaPopeCOH,+4,33,21,61%,54,2023/04/15
343,1208,,Firefly,+6,21,14,60%,35,2023/04/17
344,1207,,TomatoSoup,+3,13,7,65%,20,2023/03/21
345,1207,,Shibal,+6,15,7,68%,22,2023/04/10
346,1207,,Parasite,+9,21,10,68%,31,2023/04/16
347,1207,,Invokerka,+3,38,33,54%,71,2023/04/15
348,1207,,StephennJF,-1,18,15,55%,33,2023/04/14
349,1207,,[WD44] Judge,+4,9,4,69%,13,2023/04/16
350,1206,,FRMN,-1,9,3,75%,12,2023/04/16
351,1205,,tmass1g,+4,31,19,62%,50,2023/04/16
352,1205,,McBain,-1,25,20,56%,45,2023/04/14
353,1205,,Halophile,-3,20,11,65%,31,2023/04/11
354,1204,,-G.N-Leon·Scott·Kennedy,-1,21,12,64%,33,2023/04/13
355,1204,,TurkeysToothFactory,-6,40,32,56%,72,2023/04/17
356,1203,,rex,+4,7,3,70%,10,2023/03/22
357,1203,,Schoepsi OP AF GG LYF REKT,+1,38,27,58%,65,2023/04/16
358,1202,,VulcanHDGaming,-1,21,12,64%,33,2023/04/16
359,1202,,WebsterBolek,+1,8,5,62%,13,2023/04/11
360,1202,,Khan,+3,26,17,60%,43,2023/03/30
361,1202,,Uncle Moist,-1,36,24,60%,60,2023/04/10
362,1202,,DeathlySilent,+2,48,36,57%,84,2023/04/12
363,1201,,dylson,+1,40,22,65%,62,2023/04/16
364,1200,,Ryan Parsons,+2,11,6,65%,17,2023/03/24
365,1200,,BeeFat,-3,21,19,53%,40,2023/03/29
366,1200,,Lieut✪LunchBox,-1,10,4,71%,14,2023/04/15
367,1200,,Belfast,-3,18,14,56%,32,2023/04/03
368,1200,,Dzindzu,+1,12,7,63%,19,2023/03/23
369,1199,,GenObi,+1,30,24,56%,54,2023/04/11
370,1198,,✠ Kaiser Friedrich ✠,-2,7,3,70%,10,2023/03/24
371,1198,,Korto,+1,22,14,61%,36,2023/04/07
372,1198,,JackTW The VTUBER,-2,36,28,56%,64,2023/04/08
373,1198,,asd 546,+1,8,3,73%,11,2023/03/23
374,1198,,IpKaiFung,+3,9,3,75%,12,2023/04/15
375,1197,,matwyr,+2,23,13,64%,36,2023/04/17
376,1197,,Nériné,+2,14,7,67%,21,2023/04/10
377,1197,,GlassKnight,+3,12,6,67%,18,2023/03/25
378,1197,,Free Stasiu,-1,26,19,58%,45,2023/04/09
379,1197,,乌拉,+7,8,2,80%,10,2023/04/17
380,1196,,Bilou,+1,7,3,70%,10,2023/04/09
381,1196,,"Zoey, Cyberpunk Communist",+2,45,38,54%,83,2023/04/13
382,1196,,J_Shizlet,-3,20,14,59%,34,2023/04/03
383,1195,,ToRSpook,-3,26,19,58%,45,2023/04/15
384,1195,,Emperion,-3,9,4,69%,13,2023/03/31
385,1195,,赤色彗星,-1,9,3,75%,12,2023/03/26
386,1195,,Aenaos07,-1,17,14,55%,31,2023/04/13
387,1194,,MightyMouseJHM,+2,20,12,63%,32,2023/04/16
388,1194,,gl hf gg wp,+1,11,6,65%,17,2023/04/03
389,1194,,kimmy922,-1,35,27,56%,62,2023/04/13
390,1194,,Zaterner,-1,74,61,55%,135,2023/04/16
391,1193,,Chimp Nipples,+6,10,4,71%,14,2023/03/28
392,1192,,Hatsune Miku.tan,+1,14,9,61%,23,2023/04/11
393,1191,,moletsplui,+1,44,30,59%,74,2023/04/05
394,1191,,Cinek,-1,9,4,69%,13,2023/04/09
395,1191,,Broly,-2,12,7,63%,19,2023/03/31
396,1191,,Brits Unplayable-Give Sniper,-2,19,14,58%,33,2023/03/30
397,1191,,Gn_Patton,+1,28,18,61%,46,2023/04/13
398,1190,,Lelano,+7,17,8,68%,25,2023/04/01
399,1190,,Haluc,+2,8,4,67%,12,2023/04/06
400,1190,,pokory,+3,31,21,60%,52,2023/04/10
401,1189,,'sWiNgEz,+6,27,19,59%,46,2023/04/14
402,1189,,.Hesko.,-3,58,43,57%,101,2023/04/17
403,1188,,Pano_ramix,+2,24,17,59%,41,2023/04/05
404,1188,,Peacemaker,+1,41,35,54%,76,2023/04/18
405,1188,,Iron_Sarge69,+1,28,24,54%,52,2023/04/17
406,1188,,swdertfht,+5,8,3,73%,11,2023/04/16
407,1188,,HOI,+14,21,10,68%,31,2023/04/17
408,1187,,Nebula,-3,38,31,55%,69,2023/04/15
409,1187,,-Cr4nk-,+4,24,22,52%,46,2023/04/17
410,1187,,DirtyDan,-3,18,15,55%,33,2023/04/17
411,1186,,Obscura,-2,12,7,63%,19,2023/04/11
412,1186,,Jeiseun,+3,64,56,53%,120,2023/04/01
413,1185,,Gray,+4,9,3,75%,12,2023/03/31
414,1185,,Punk McThrust,+1,14,9,61%,23,2023/04/02
415,1184,,dire,-1,117,97,55%,214,2023/04/18
416,1184,,WayTooTicklish,-1,7,3,70%,10,2023/04/04
417,1184,,阴险恶毒熊主任,+5,10,4,71%,14,2023/03/30
418,1184,,herby7,-3,199,170,54%,369,2023/04/16
419,1184,,Andii,-4,8,4,67%,12,2023/03/29
420,1184,,Tobimara,-3,156,141,53%,297,2023/04/08
421,1183,,Shito,+5,18,11,62%,29,2023/04/17
422,1183,,ZRL454,-1,8,3,73%,11,2023/04/07
423,1183,,Stryker,+1,21,15,58%,36,2023/04/02
424,1183,,Montaign3,+1,10,6,63%,16,2023/04/12
425,1182,,嘉然今晚吃什么,-1,27,24,53%,51,2023/04/06
426,1182,,bluegreen,+3,13,8,62%,21,2023/03/31
427,1182,,Helyea,+4,7,4,64%,11,2023/04/14
428,1182,,Mastrolorenzo,-1,8,4,67%,12,2023/04/15
429,1181,,yapster,+3,9,3,75%,12,2023/04/11
430,1181,,八坂真崎,-5,16,13,55%,29,2023/04/15
431,1181,,CHB19 TerrorKoala,+2,8,3,73%,11,2023/04/08
432,1181,,OdaKenji,-2,11,6,65%,17,2023/04/11
433,1181,,Storm,+6,15,6,71%,21,2023/04/01
434,1181,,Testicular Chewing Goat,-2,23,15,61%,38,2023/04/04
435,1180,,Sharpg,-1,14,9,61%,23,2023/03/27
436,1180,,bog,+1,31,24,56%,55,2023/04/15
437,1180,,Gorka,-1,16,10,62%,26,2023/03/27
438,1180,,Insomniac,+2,91,77,54%,168,2023/04/17
439,1179,,CantCNC,+6,9,3,75%,12,2023/04/02
440,1179,,limewizz,-1,7,3,70%,10,2023/03/29
441,1178,,Carne,-1,38,30,56%,68,2023/04/17
442,1178,,drunken JEFFERY thug,+3,54,43,56%,97,2023/04/16
443,1178,,Kronie,+2,57,39,59%,96,2023/04/07
444,1177,,SweetConnection,+3,8,3,73%,11,2023/04/02
445,1177,,PeterGriffin,-1,20,16,56%,36,2023/04/12
446,1177,,Lifer,+5,20,11,65%,31,2023/04/16
447,1177,,RunningFatKids,+2,8,4,67%,12,2023/04/17
448,1176,,Stormless,-1,17,13,57%,30,2023/04/17
449,1175,,Haze,+7,23,15,61%,38,2023/04/03
450,1175,,The_Mad_Hat,+2,8,3,73%,11,2023/04/09
451,1175,,Lethal,+2,32,24,57%,56,2023/04/15
452,1175,,Royal Annihilator,-1,7,4,64%,11,2023/04/13
453,1175,,Bulars,+1,40,35,53%,75,2023/04/09
454,1174,,Riftwalker,+3,10,5,67%,15,2023/04/16
455,1174,,Erwin Rommel,-1,50,40,56%,90,2023/04/06
456,1174,,C.G. Jung,-3,20,14,59%,34,2023/04/14
457,1173,,Sarg gX,+7,9,4,69%,13,2023/03/24
458,1173,,cold fingers,-1,9,5,64%,14,2023/03/25
459,1173,,lp,+2,10,6,63%,16,2023/04/16
460,1173,,Hodolf,-1,22,13,63%,35,2023/04/12
461,1173,,Empa,+2,28,27,51%,55,2023/04/15
462,1173,,George,+1,13,7,65%,20,2023/04/15
463,1172,,Viklas,-1,8,4,67%,12,2023/04/06
464,1172,,rain,-2,13,8,62%,21,2023/04/17
465,1172,,ralneck52,-1,35,27,56%,62,2023/04/02
466,1171,,Mantra,+1,14,8,64%,22,2023/04/14
467,1171,,Sedghammer,+1,13,6,68%,19,2023/03/31
468,1169,,a hell on earth,+1,11,8,58%,19,2023/04/06
469,1169,,BeerGrills,+5,19,15,56%,34,2023/04/17
470,1168,,Franz,+2,13,8,62%,21,2023/04/07
471,1168,,Nevraths,+1,73,68,52%,141,2023/04/17
472,1168,,Cheroid,+1,13,7,65%,20,2023/04/17
473,1168,,eMBeLeS,-2,10,7,59%,17,2023/04/13
474,1168,,Schwinto,+3,9,4,69%,13,2023/03/30
475,1167,,TheKingofRome,+1,61,49,55%,110,2023/03/28
476,1167,,F1NGGY,+1,13,8,62%,21,2023/04/14
477,1166,,sk23,+7,14,7,67%,21,2023/04/14
478,1166,,3imWeckla,+1,23,19,55%,42,2023/04/10
479,1165,,EG_DirtyKen,+1,21,21,50%,42,2023/04/16
480,1164,,tangojuliett,+2,42,34,55%,76,2023/04/17
481,1164,,JohnGrammaticus,-1,50,46,52%,96,2023/04/14
482,1164,,EtherealDragon,+4,13,7,65%,20,2023/03/29
483,1164,,SHVAKS,-3,25,20,56%,45,2023/04/04
484,1164,,Cpt. Paws,+1,7,3,70%,10,2023/04/08
485,1163,,Corvo Attano,-3,11,9,55%,20,2023/03/24
486,1163,,只愛❤毛妹,+2,25,18,58%,43,2023/03/28
487,1162,,Fanatic,+1,8,4,67%,12,2023/03/30
488,1162,,J0kiee,+1,8,3,73%,11,2023/04/03
489,1162,,Beregonds,+8,13,5,72%,18,2023/04/05
490,1161,,鸡饲料锐评农场主,-1,26,22,54%,48,2023/04/13
491,1161,,Imaturkeith,-3,92,86,52%,178,2023/04/16
492,1161,,Parasonic,-1,31,23,57%,54,2023/04/04
493,1161,,Pinky```,+1,22,21,51%,43,2023/04/17
494,1161,,Le Quack,-4,17,15,53%,32,2023/04/05
495,1160,,Malevolent Pink Cat,-5,9,8,53%,17,2023/04/13
496,1160,,[ARG]MataPretinho,-1,33,30,52%,63,2023/04/17
497,1160,,Xinner,-1,69,63,52%,132,2023/04/09
498,1159,,CookiEZ,+1,41,36,53%,77,2023/04/15
499,1159,,Fat Nanny,+1,25,22,53%,47,2023/04/09
500,1158,,Skyfire,-2,13,9,59%,22,2023/04/13
501,1158,,Joker239,+3,18,12,60%,30,2023/03/31
502,1158,,Wayne_Wang,-1,7,4,64%,11,2023/04/05
503,1157,,zhuk0v,-2,22,20,52%,42,2023/04/16
504,1157,,Wolfe,+4,19,12,61%,31,2023/04/17
505,1157,,Sevas,-2,28,21,57%,49,2023/03/26
506,1157,,·,-2,13,10,57%,23,2023/04/10
507,1156,,AfroNinja,+1,10,8,56%,18,2023/03/23
508,1156,,PG88,-5,14,11,56%,25,2023/04/07
509,1156,,rodent of noteworthy size,+1,40,35,53%,75,2023/04/05
510,1156,,101st.Airbone,-2,7,4,64%,11,2023/04/13
511,1156,,Morsezeichen,-2,51,48,52%,99,2023/04/10
512,1155,,D4rkKr1s,+5,46,39,54%,85,2023/04/17
513,1155,,joe jan,-2,9,7,56%,16,2023/04/17
514,1155,,Xzc1,+3,16,10,62%,26,2023/03/26
515,1155,,germ,+4,20,15,57%,35,2023/04/06
516,1154,,JosephTheGreat,+7,11,5,69%,16,2023/04/02
517,1154,,companyHOLLAND,+1,11,7,61%,18,2023/04/15
518,1153,,darkerdayzud,-1,24,16,60%,40,2023/03/31
519,1153,,dolph,+5,24,17,59%,41,2023/04/15
520,1153,,Thermidor,+2,15,10,60%,25,2023/04/02
521,1153,,BlueComp[A]ny,-1,6,4,60%,10,2023/04/06
522,1152,,Johnny 99,-1,8,4,67%,12,2023/04/01
523,1152,,Flyerton99,-1,7,3,70%,10,2023/03/27
524,1152,,Jean Paul Borat,+2,8,5,62%,13,2023/04/12
525,1152,,|DCC|Freestyler,-3,7,6,54%,13,2023/04/11
526,1152,,Tepuche,-2,47,38,55%,85,2023/04/17
527,1151,,RIZAs,+1,22,18,55%,40,2023/03/28
528,1151,,Amouranth,+1,16,14,53%,30,2023/03/21
529,1151,,Alcoholic father,-1,8,5,62%,13,2023/04/16
530,1151,,BusinessBryce,+1,48,41,54%,89,2023/04/13
531,1151,,Destroyer,+3,13,8,62%,21,2023/04/07
532,1151,,SturmTigerGiap,-1,8,6,57%,14,2023/04/05
533,1150,,TowerNumberNine,+2,34,28,55%,62,2023/04/13
534,1150,,Lars,+1,15,10,60%,25,2023/04/10
535,1150,,🏹tȟogktékA🔪💀🪓,-1,55,54,50%,109,2023/04/07
536,1149,,Wuppie,+1,13,8,62%,21,2023/04/15
537,1149,,Gumshoe.Cambro,+6,46,39,54%,85,2023/04/12
538,1149,,John Paul II,-1,13,8,62%,21,2023/04/08
539,1149,,nonononononononono,-3,20,15,57%,35,2023/04/15
540,1149,,BadmanLarry,+1,125,105,54%,230,2023/04/16
541,1148,,FocXD_YT,-3,33,28,54%,61,2023/04/13
542,1147,,KaGo,-3,27,23,54%,50,2023/04/01
543,1147,,Showdawg,-1,22,18,55%,40,2023/03/25
544,1147,,Stempolbyku,+2,14,10,58%,24,2023/03/25
545,1147,,Lanfeust,+1,30,24,56%,54,2023/04/16
546,1147,,Endless Pera,-1,7,4,64%,11,2023/04/13
547,1147,,qqwqqp,-1,16,11,59%,27,2023/03/29
548,1146,,cease2existt,-1,11,5,69%,16,2023/04/06
549,1146,,NeuralBooch,+2,10,6,63%,16,2023/04/02
550,1145,,Desertfox,-5,19,15,56%,34,2023/04/17
551,1145,,phx.Mohikaner,-1,27,20,57%,47,2023/04/14
552,1145,,KoSa®,+3,14,9,61%,23,2023/04/15
553,1145,,Adrian Calu,-3,19,14,58%,33,2023/03/27
554,1145,,Andrax,+1,24,14,63%,38,2023/04/12
555,1144,,Oda,-2,40,35,53%,75,2023/04/07
556,1144,,Cider,+1,27,18,60%,45,2023/04/16
557,1144,,Protez,-1,62,55,53%,117,2023/03/29
558,1144,,Trivolka,+7,29,24,55%,53,2023/04/17
559,1144,,Lick3tySplit,-4,22,18,55%,40,2023/04/17
560,1143,,(⊙o⊙)…,-1,125,121,51%,246,2023/04/18
561,1143,,Lippo,+1,23,20,53%,43,2023/04/12
562,1143,,Oskar,-1,45,38,54%,83,2023/03/27
563,1142,,Sticket,+6,22,13,63%,35,2023/04/10
564,1142,,Drew-bert,-1,39,30,57%,69,2023/04/08
565,1142,,EVILUTION,-2,22,21,51%,43,2023/04/16
566,1140,,AndreiM2006,+2,23,19,55%,42,2023/04/17
567,1140,,Dromaeda,-5,59,54,52%,113,2023/04/06
568,1140,,smithers43,-1,92,88,51%,180,2023/04/15
569,1140,,HAN-[cw]100980315,-2,11,8,58%,19,2023/04/09
570,1140,,Blackwing7777,+1,9,5,64%,14,2023/04/12
571,1139,,FOM,-1,9,6,60%,15,2023/03/29
572,1139,,GuillanoBallardo,+2,20,13,61%,33,2023/04/05
573,1139,,Trademark,+2,11,7,61%,18,2023/04/11
574,1139,,taco,+1,7,3,70%,10,2023/03/27
575,1139,,Frost,-1,8,6,57%,14,2023/03/29
576,1139,,Fernando87ca,-2,37,30,55%,67,2023/04/15
577,1139,,clippen05,+2,20,14,59%,34,2023/04/08
578,1138,,Mahuna,-3,24,18,57%,42,2023/04/04
579,1138,,Demi,+3,48,40,55%,88,2023/04/05
580,1137,,Chibitz,-2,28,20,58%,48,2023/03/24
581,1137,,69apm,+2,6,4,60%,10,2023/04/13
582,1136,,BunnyBlender,-2,31,29,52%,60,2023/03/27
583,1136,,Super Ben,+5,14,8,64%,22,2023/03/31
584,1136,,Torototo2,+1,38,35,52%,73,2023/04/08
585,1135,,MR Dun,-3,18,17,51%,35,2023/03/24
586,1135,,Kiju,+2,23,22,51%,45,2023/04/10
587,1135,,HamSAMwich,-1,10,9,53%,19,2023/03/26
588,1135,,Dire_Wolf,+1,46,38,55%,84,2023/03/30
589,1134,,FlyingDutchman,-1,21,17,55%,38,2023/04/15
590,1134,,kluwejo,+1,9,6,60%,15,2023/04/05
591,1133,,BugSplatMann,+3,13,8,62%,21,2023/03/24
592,1133,,Glorb,+3,10,6,63%,16,2023/03/28
593,1133,,Esel,-1,9,5,64%,14,2023/04/15
594,1133,,Sh@dow,+1,17,18,49%,35,2023/04/15
595,1133,,MrWhiskey,+1,12,8,60%,20,2023/04/10
596,1133,,白织,-1,11,7,61%,18,2023/03/21
597,1132,,Srbija,-1,30,28,52%,58,2023/04/17
598,1132,,AkularMk2,-1,8,5,62%,13,2023/03/31
599,1132,,BigGameHUnter,+3,18,13,58%,31,2023/04/16
600,1132,,Gooby,-1,49,49,50%,98,2023/04/03
601,1132,,[IRS] EBass,-4,17,13,57%,30,2023/04/15
602,1132,,'Sexx Luthor,-1,8,6,57%,14,2023/04/02
603,1131,,acefromspace,-1,24,18,57%,42,2023/03/30
604,1131,,Kirov,+1,34,32,52%,66,2023/04/08
605,1131,,CaptainKraut,+1,7,4,64%,11,2023/03/22
606,1131,,VV_Goth_VV,+1,16,10,62%,26,2023/03/21
607,1131,,kiwi,+1,75,70,52%,145,2023/04/17
608,1131,,turkey cat,+1,31,27,53%,58,2023/04/13
609,1131,,chobandi,+2,18,14,56%,32,2023/04/10
610,1130,,Daemon7,+3,17,11,61%,28,2023/04/17
611,1130,,Herodad,-5,7,8,47%,15,2023/03/26
612,1130,,T_Bag60,+2,9,5,64%,14,2023/04/08
613,1130,,sfc.14,+2,6,4,60%,10,2023/04/07
614,1129,,potassium,-1,7,3,70%,10,2023/03/24
615,1129,,HasBeenDropped,+2,10,6,63%,16,2023/04/03
616,1129,,MyFunction,-2,30,23,57%,53,2023/04/04
617,1129,,Crusader From The Future,+1,39,30,57%,69,2023/04/13
618,1129,,RKnightxX,+2,49,44,53%,93,2023/03/29
619,1128,,Hayesy,+3,18,17,51%,35,2023/04/16
620,1128,,DPJ_realy,+3,15,11,58%,26,2023/03/22
621,1128,,Hachald,+6,8,4,67%,12,2023/04/16
622,1128,,Eisenblut,+1,6,4,60%,10,2023/03/29
623,1128,,Reactive,+1,33,27,55%,60,2023/04/13
624,1128,,ChiefRedSkins,-5,26,27,49%,53,2023/04/12
625,1128,,BrainlesS,-2,13,10,57%,23,2023/04/07
626,1128,,ARMY guy,+1,10,7,59%,17,2023/03/28
627,1127,,Ξ kiralacus,+1,7,4,64%,11,2023/03/27
628,1127,,hubewa,-1,12,11,52%,23,2023/04/07
629,1127,,Wreath Noël,-2,11,9,55%,20,2023/04/08
630,1127,,Blysk,+3,17,13,57%,30,2023/03/24
631,1127,,Mintjack,+2,11,9,55%,20,2023/04/14
632,1127,,Jafar,+3,11,7,61%,18,2023/04/14
633,1126,,Tank,+2,10,7,59%,17,2023/03/30
634,1126,,xd,-1,6,4,60%,10,2023/04/10
635,1126,,tubagznyven,+2,32,25,56%,57,2023/04/17
636,1126,,Quattroruote,-2,78,69,53%,147,2023/04/01
637,1126,,aleX ツ,+1,13,10,57%,23,2023/04/08
638,1126,,Topone,+2,49,46,52%,95,2023/04/16
639,1126,,Ruhrfale,-2,7,7,50%,14,2023/04/06
640,1126,,Malenkiy_Apelsin,+2,22,20,52%,42,2023/04/17
641,1125,,Haxses,-1,11,7,61%,18,2023/03/27
642,1125,,D3kay,-5,189,183,51%,372,2023/04/17
643,1124,,Samson (MykillJackson),+2,7,4,64%,11,2023/04/15
644,1124,,Sujy,+1,48,38,56%,86,2023/04/13
645,1123,,Prince Farming,+3,14,9,61%,23,2023/04/08
646,1123,,LB,-2,27,22,55%,49,2023/04/11
647,1123,,Xufe,-9,26,30,46%,56,2023/04/12
648,1123,,Saxonyflori,+3,17,13,57%,30,2023/04/15
649,1123,,AE,+1,15,13,54%,28,2023/03/25
650,1123,,给我一颗星,+1,13,11,54%,24,2023/04/13
651,1122,,CrazyEight1994,-1,11,9,55%,20,2023/04/13
652,1121,,snafu,+2,12,7,63%,19,2023/03/22
653,1121,,Gotzendorf,-1,12,8,60%,20,2023/04/06
654,1121,,TheRealDeadMan17,-1,8,5,62%,13,2023/04/03
655,1121,,Zuntew...,+1,35,30,54%,65,2023/04/18
656,1121,,King Jelly Chip Chip,+2,11,6,65%,17,2023/04/17
657,1120,,MattJeburt,+1,12,8,60%,20,2023/04/15
658,1120,,SLOARMOR hiltyEyE,-1,20,14,59%,34,2023/04/17
659,1120,,Fresh_Mint,+3,10,6,63%,16,2023/03/26
660,1119,,🐫🐎🐫🐫🐎🐫🐫🐎,+3,14,12,54%,26,2023/03/28
661,1119,,MoonLover138,+1,14,11,56%,25,2023/04/07
662,1118,,Duke,-2,10,6,63%,16,2023/04/01
663,1118,,๖ۣۜF1re,-1,52,47,53%,99,2023/04/17
664,1118,,АЛЕКСАНДРО1972,-1,15,14,52%,29,2023/04/12
665,1117,,bLiTz,-1,147,142,51%,289,2023/03/25
666,1117,,Larry Lobster,-1,14,11,56%,25,2023/04/14
667,1117,,kdguno,-2,27,21,56%,48,2023/04/11
668,1117,,2506Brigade,+1,30,25,55%,55,2023/04/16
669,1117,,In It For The Hats,+1,24,19,56%,43,2023/03/24
670,1117,,Boskever!?,+3,11,6,65%,17,2023/04/01
671,1117,,runningDuck,+3,12,8,60%,20,2023/04/15
672,1117,,Etiyen,-1,55,51,52%,106,2023/04/12
673,1117,,Task Force X,+1,29,22,57%,51,2023/04/15
674,1117,,锅连长,-2,22,14,61%,36,2023/04/13
675,1116,,Fredboy3000,-1,18,13,58%,31,2023/04/08
676,1116,,Homeless,+1,20,13,61%,33,2023/04/11
677,1115,,Kübelwagen!,+1,90,87,51%,177,2023/04/14
678,1115,,Skyguy,-1,8,6,57%,14,2023/03/28
679,1115,,Matoux,+1,8,5,62%,13,2023/03/25
680,1114,,Timothy McWhiskers,+1,25,18,58%,43,2023/04/10
681,1114,,montag,-4,42,36,54%,78,2023/04/15
682,1114,,SmoothieOutOfGoofy,+8,21,17,55%,38,2023/04/14
683,1114,,Snoop',+1,17,12,59%,29,2023/03/26
684,1114,,Euan,+1,43,39,52%,82,2023/04/17
685,1114,,lordmark369,+2,9,6,60%,15,2023/04/08
686,1113,,★Colonel-zuvyna★,+7,30,23,57%,53,2023/04/13
687,1113,,Porco Rosso,-2,14,11,56%,25,2023/04/13
688,1113,,fulisek23,+2,15,10,60%,25,2023/03/29
689,1113,,Jens,-2,23,18,56%,41,2023/04/07
690,1113,,Adadis,-1,13,13,50%,26,2023/03/25
691,1113,,Winnie the Alchemist,+2,13,10,57%,23,2023/04/14
692,1112,,1st SubStar,-5,12,12,50%,24,2023/03/21
693,1111,,伊卡洛斯,-1,34,29,54%,63,2023/04/15
694,1111,,DALT11,-4,36,30,55%,66,2023/04/07
695,1111,,BortekThePigeon,+5,13,8,62%,21,2023/04/01
696,1111,,commissioner,-2,7,3,70%,10,2023/04/06
697,1111,,JJuKKuRi,+2,13,8,62%,21,2023/04/05
698,1111,,Sojourner,+1,9,6,60%,15,2023/03/29
699,1111,,Talboss,-2,27,24,53%,51,2023/04/05
700,1110,,Leninade,-4,20,18,53%,38,2023/04/10
701,1110,,[Ace] Mango Rage,+2,18,13,58%,31,2023/04/10
702,1110,,twitchtvflekz127,-4,49,43,53%,92,2023/04/16
703,1110,,S K E N G,-2,6,4,60%,10,2023/03/26
704,1110,,Lergen,-2,102,101,50%,203,2023/04/13
705,1110,,狂奔的海螺,+2,211,220,49%,431,2023/04/17
706,1110,,Angry Android,-2,11,8,58%,19,2023/04/09
707,1109,,Sir,+1,7,6,54%,13,2023/04/05
708,1109,,你挺住我转中,-1,7,4,64%,11,2023/04/14
709,1108,,Adonis Creed,-3,53,41,56%,94,2023/03/29
710,1108,,Vasilisk,+3,11,8,58%,19,2023/03/31
711,1108,,总维新,+2,9,6,60%,15,2023/04/04
712,1108,,Snazzy,+2,18,15,55%,33,2023/04/13
713,1107,,Royale with Cheese,-1,15,12,56%,27,2023/04/06
714,1107,,Emil,+4,11,6,65%,17,2023/03/30
715,1107,,judacomrun,+3,41,43,49%,84,2023/04/15
716,1106,,zoi,-1,14,9,61%,23,2023/04/14
717,1106,,[THT] Thusanai,+1,7,6,54%,13,2023/04/15
718,1106,,Hagga,+3,16,12,57%,28,2023/04/11
719,1106,,403671774,-1,35,25,58%,60,2023/04/16
720,1106,,Gus Fring,-2,17,12,59%,29,2023/03/30
721,1106,,Bucho Burns,+1,14,15,48%,29,2023/03/26
722,1106,,NoMatterWha,-2,24,20,55%,44,2023/04/17
723,1106,,ъסּסּⁿ»Stoffa,-2,7,4,64%,11,2023/03/27
724,1106,,Mr.Kal,-2,10,9,53%,19,2023/04/16
725,1106,,[DLB] Wolfen,-1,19,13,59%,32,2023/04/09
726,1105,,DarkPact,+4,7,4,64%,11,2023/04/06
727,1105,,spz,-1,30,22,58%,52,2023/04/11
728,1104,,VndctL,-1,11,7,61%,18,2023/04/16
729,1104,,qducryzz,-1,35,31,53%,66,2023/04/16
730,1104,,Fuzzy Panda,-2,9,6,60%,15,2023/04/11
731,1102,,Rasta69,+2,20,19,51%,39,2023/04/15
732,1102,,Le rat Madan,-2,12,10,55%,22,2023/04/12
733,1102,,Inops,-1,8,6,57%,14,2023/04/11
734,1102,,SnooSnarry,-2,28,23,55%,51,2023/04/18
735,1102,,ScarletShin,+2,7,5,58%,12,2023/04/15
736,1102,,Schäper,-1,36,33,52%,69,2023/04/08
737,1101,,J3WN1aL8T0R,+1,29,33,47%,62,2023/04/13
738,1101,,DodoSlayer27,+6,33,26,56%,59,2023/04/14
739,1100,,Tré,+1,13,10,57%,23,2023/04/07
740,1100,,Finesse,+2,6,4,60%,10,2023/04/10
741,1099,,Briefcase Taco,-2,9,6,60%,15,2023/04/02
742,1099,,Templariusz,+6,9,6,60%,15,2023/04/06
743,1099,,BigLang,+3,6,4,60%,10,2023/04/05
744,1099,,0rozco,+5,9,5,64%,14,2023/04/15
745,1098,,sirota,+2,70,67,51%,137,2023/04/09
746,1098,,The Iron Duke,-1,8,5,62%,13,2023/04/13
747,1098,,MR.Elpőehant,+1,6,5,55%,11,2023/04/13
748,1098,,Auteeno_Manzano,-1,9,7,56%,16,2023/04/08
749,1097,,sachetti,-1,27,24,53%,51,2023/04/10
750,1097,,Sinverguenza,+4,26,21,55%,47,2023/04/12
751,1097,,나이트오브,+1,29,20,59%,49,2023/04/17
752,1097,,Philbit,+1,14,12,54%,26,2023/03/23
753,1097,,suxiaquan,+3,15,11,58%,26,2023/04/07
754,1097,,meow,-2,37,34,52%,71,2023/04/12
755,1097,,JuliiG,+1,12,9,57%,21,2023/03/31
756,1096,,Letter Opener,+3,9,6,60%,15,2023/04/03
757,1096,,Firewasp,-2,11,9,55%,20,2023/03/30
758,1096,,EricElite,+1,45,43,51%,88,2023/03/22
759,1096,,Hinkel,+2,6,4,60%,10,2023/04/16
760,1095,,Kraut,-3,14,13,52%,27,2023/04/05
761,1095,,Dragon,+2,17,11,61%,28,2023/03/21
762,1095,,ToYson,-1,9,7,56%,16,2023/04/01
763,1095,,Nesli,+1,6,4,60%,10,2023/04/14
764,1094,,5th_Terror,-3,13,11,54%,24,2023/03/24
765,1094,,Hefe,-1,21,15,58%,36,2023/04/10
766,1093,,Damgard,-3,50,44,53%,94,2023/03/22
767,1092,,Dr. T,+1,7,6,54%,13,2023/04/01
768,1092,,SzarywilkPL,+7,19,14,58%,33,2023/04/16
769,1092,,Samp,+2,79,67,54%,146,2023/04/15
770,1092,,Phillip II - Wardaddy,-2,13,10,57%,23,2023/04/15
771,1092,,CXUNTA'S,-3,16,13,55%,29,2023/03/21
772,1092,,CeerEd,-5,12,11,52%,23,2023/03/24
773,1092,,leo881202,+2,7,4,64%,11,2023/04/13
774,1092,,Hemera.Helio,-1,17,12,59%,29,2023/03/24
775,1091,,maousaki,+3,6,4,60%,10,2023/03/25
776,1091,,hakuna_nochildsopportgodfathe,+2,7,5,58%,12,2023/04/08
777,1091,,Doongie,+2,8,8,50%,16,2023/04/01
778,1091,,SHALDUN,+2,9,7,56%,16,2023/03/26
779,1091,,TheGoodMoose,-3,14,14,50%,28,2023/04/12
780,1091,,marcmorn,+1,7,5,58%,12,2023/03/30
781,1090,,D O M I N A T E,-1,11,10,52%,21,2023/04/07
782,1090,,DooWop,+1,14,10,58%,24,2023/03/27
783,1090,,subzero_86,-2,46,45,51%,91,2023/04/16
784,1090,,XQC,+1,9,6,60%,15,2023/04/06
785,1090,,bnw,+1,13,10,57%,23,2023/04/16
786,1090,,UncleSpam®,+2,18,16,53%,34,2023/04/02
787,1089,,Meepo xceL,-2,16,11,59%,27,2023/03/23
788,1089,,aero,+1,6,4,60%,10,2023/03/29
789,1088,,Protein,+2,29,29,50%,58,2023/04/08
790,1088,,Panzer64,-1,6,5,55%,11,2023/03/21
791,1087,,Mint Juul Pod,-1,49,44,53%,93,2023/04/01
792,1087,,xXCarl-Johan-Sonesson-GamingXx,-5,8,7,53%,15,2023/04/03
793,1087,,Bland Unicorn,-1,72,71,50%,143,2023/04/08
794,1087,,Hagarth #JDWT,-1,7,5,58%,12,2023/03/26
795,1087,,sgusgu,-5,9,9,50%,18,2023/04/04
796,1087,,Bomberazo,+2,7,5,58%,12,2023/04/16
797,1087,,Fatefullemons,-1,8,5,62%,13,2023/04/03
798,1086,,-BA- Syrisssamson,-1,16,16,50%,32,2023/04/05
799,1086,,Ekko Tek,-4,14,14,50%,28,2023/04/07
800,1086,,Jangles,+1,15,12,56%,27,2023/04/17
801,1086,,churchmf,+2,9,8,53%,17,2023/04/08
802,1086,,Brujoga10,-1,7,5,58%,12,2023/03/26
803,1085,,Fookin' Laser Sights,+4,20,16,56%,36,2023/04/11
804,1085,,AngelSSword,+1,15,11,58%,26,2023/04/06
805,1084,,IVAR TB,+1,12,10,55%,22,2023/04/13
806,1084,,Project Reality King,+1,19,16,54%,35,2023/03/23
807,1084,,Levarious,-3,6,4,60%,10,2023/03/25
808,1084,,UA - ♠ $imA ♠,+2,7,6,54%,13,2023/03/30
809,1083,,BugSplat,+2,28,20,58%,48,2023/04/12
810,1083,,Mr Gizard The Lizard Wizard,+1,11,10,52%,21,2023/04/16
811,1083,,理塘絕兇の猛虎！純真丁一郎です,-1,44,46,49%,90,2023/04/16
812,1083,,Envisionaried,+2,15,10,60%,25,2023/04/13
813,1082,,Besh,-1,23,22,51%,45,2023/04/09
814,1082,,✠ℜℌℭiℵ✠ℳℭ☦ΔLL,+2,11,11,50%,22,2023/04/14
815,1082,,Brührer,+1,8,6,57%,14,2023/04/10
816,1082,,巴克舔巨海豹 Twitch,+1,36,35,51%,71,2023/04/16
817,1081,,𝕊𝕠𝕦𝕡🥣GOᗪ,+1,9,7,56%,16,2023/04/08
818,1081,,Potatooio,-1,9,8,53%,17,2023/04/16
819,1081,,Demigore,-2,8,6,57%,14,2023/04/12
820,1081,,DASIROVA,-1,7,6,54%,13,2023/04/14
821,1081,,el deglingoo,-1,14,13,52%,27,2023/04/05
822,1081,,7UziTotingMonkeys,+1,8,7,53%,15,2023/04/09
823,1081,,MyDiamonD,-1,10,8,56%,18,2023/03/28
824,1080,,Marius,+1,13,8,62%,21,2023/04/14
825,1080,,Apfelsaft92,-1,7,4,64%,11,2023/04/12
826,1080,,✡ Merchant ✡,-1,16,14,53%,30,2023/04/06
827,1080,,Khayyam,+1,8,5,62%,13,2023/04/14
828,1079,,Bertha The Child,+1,10,8,56%,18,2023/04/13
829,1079,,Mr.Drix,+3,24,18,57%,42,2023/03/21
830,1079,,Maup,-2,14,16,47%,30,2023/04/12
831,1079,,Cpt. Unicorn,+5,20,15,57%,35,2023/04/17
832,1079,,Jopjahh,+2,10,8,56%,18,2023/04/17
833,1079,,A-Hörnchen,-2,33,29,53%,62,2023/04/12
834,1078,,benjaminespindola001,-1,9,6,60%,15,2023/03/23
835,1078,,GrimReaper,+1,12,10,55%,22,2023/04/02
836,1078,,mr.t-87,+2,40,34,54%,74,2023/04/17
837,1077,,Mit,-1,17,12,59%,29,2023/04/08
838,1077,,Ruthless Player,+5,95,93,51%,188,2023/04/17
839,1077,,Dr.Gonzo,-2,76,84,48%,160,2023/04/16
840,1077,,Dwayne The Cock Johnson,+2,7,5,58%,12,2023/04/11
841,1075,,Injurwii,-1,9,7,56%,16,2023/04/03
842,1075,,Simped,-1,18,15,55%,33,2023/04/09
843,1075,,Flavius Constantinus,+1,57,55,51%,112,2023/04/11
844,1075,,我剑也未尝不利,-2,13,10,57%,23,2023/03/25
845,1075,,Person,+1,8,6,57%,14,2023/03/21
846,1074,,Vince,+1,32,29,52%,61,2023/04/11
847,1074,,Auxiliary Priest,+1,10,8,56%,18,2023/03/29
848,1074,,Stonik,-2,14,12,54%,26,2023/04/16
849,1074,,Froziik,-1,38,36,51%,74,2023/04/17
850,1074,,CocusMagnus,+1,7,6,54%,13,2023/03/21
851,1073,,DPdangi28,+2,19,16,54%,35,2023/04/09
852,1073,,Tantalus,+2,36,34,51%,70,2023/04/10
853,1073,,Jeffason el boxon,+2,6,4,60%,10,2023/04/17
854,1073,,CaptainC0w,-1,8,7,53%,15,2023/03/24
855,1073,,beniu,-2,7,6,54%,13,2023/04/16
856,1073,,Molloch,-1,18,16,53%,34,2023/03/31
857,1073,,Patchouli Knowledge,-6,26,28,48%,54,2023/03/28
858,1072,,Cinder,+1,9,8,53%,17,2023/04/17
859,1071,,Eagle_One,-1,36,30,55%,66,2023/03/21
860,1071,,ElGranEagle,-2,33,31,52%,64,2023/03/29
861,1071,,中國武漢肺炎,-3,7,8,47%,15,2023/04/12
862,1071,,恩恩,-3,43,40,52%,83,2023/04/14
863,1071,,Light,-1,8,7,53%,15,2023/04/08
864,1070,,Dave,-2,8,7,53%,15,2023/04/14
865,1069,,Lady Rytsu,+1,11,11,50%,22,2023/04/11
866,1069,,Dawes,+1,22,23,49%,45,2023/03/30
867,1069,,OnkelDoktor,-1,37,34,52%,71,2023/03/21
868,1069,,helpme,+2,18,14,56%,32,2023/04/13
869,1069,,[TakTakTak]Boys,-1,8,6,57%,14,2023/04/08
870,1069,,AlterFritz,+2,30,24,56%,54,2023/03/28
871,1068,,KrazyKoala,-1,24,20,55%,44,2023/04/08
872,1068,,CasuallyLax,-1,23,20,53%,43,2023/04/16
873,1068,,猫头鹰,-4,234,230,50%,464,2023/04/07
874,1068,,犀利哥0577,-1,26,24,52%,50,2023/04/17
875,1068,,Virgile[FR],+1,14,14,50%,28,2023/04/16
876,1068,,Beouchen,+4,7,4,64%,11,2023/04/11
877,1068,,Mr Indigo,-2,9,8,53%,17,2023/03/22
878,1067,,Mackermicker,-1,7,5,58%,12,2023/04/17
879,1067,,Stemonitis,-2,17,11,61%,28,2023/04/11
880,1067,,AlphaOmega,-1,30,30,50%,60,2023/04/10
881,1067,,Luipaard,+1,33,31,52%,64,2023/04/05
882,1067,,[1stEB]Jumbowokkels,-5,27,22,55%,49,2023/04/13
883,1067,,Kannamix,+3,10,8,56%,18,2023/04/16
884,1066,,绮靡之音,+3,7,4,64%,11,2023/03/30
885,1066,,Wind,+3,16,14,53%,30,2023/04/15
886,1065,,The Royal Ninja,+1,7,6,54%,13,2023/03/27
887,1065,,Soja,+3,16,14,53%,30,2023/04/06
888,1064,,oCelot,-2,14,14,50%,28,2023/04/09
889,1064,,N3oX,+5,19,13,59%,32,2023/04/12
890,1064,,Hawkkinson,+1,5,6,45%,11,2023/03/29
891,1064,,Shikabane,-1,31,27,53%,58,2023/04/11
892,1064,,Roderik,+3,27,26,51%,53,2023/04/15
893,1063,,Imperates,-3,5,5,50%,10,2023/04/03
894,1063,,GrownUp,+2,10,8,56%,18,2023/04/06
895,1063,,AndreMafia,+3,21,23,48%,44,2023/04/16
896,1063,,Kalpa Kassinen,-1,5,5,50%,10,2023/03/23
897,1063,,FenneQ,-1,13,12,52%,25,2023/04/01
898,1063,,Imouto Headpat,+2,28,25,53%,53,2023/04/11
899,1062,,lolmoe,-3,20,20,50%,40,2023/03/21
900,1062,,Smokindro420,-1,6,4,60%,10,2023/03/23
901,1062,,孤云阁 F4,-2,11,12,48%,23,2023/03/26
902,1062,,Wolfsindis,+1,6,6,50%,12,2023/04/14
903,1062,,Kaypen97,-3,17,16,52%,33,2023/03/27
904,1061,,SturmdereWani,-2,6,4,60%,10,2023/04/15
905,1061,,RoXoR,+1,9,8,53%,17,2023/04/02
906,1061,,Rocky0730,-1,22,23,49%,45,2023/04/15
907,1061,,Reculus,+1,6,5,55%,11,2023/03/28
908,1061,,TopG,+1,132,136,49%,268,2023/04/18
909,1061,,influenser,+1,8,6,57%,14,2023/03/25
910,1060,,[SITH] Gilneos,+3,47,38,55%,85,2023/04/03
911,1060,,Jingle,+1,6,6,50%,12,2023/04/17
912,1060,,Enfelon,+1,60,53,53%,113,2023/04/18
913,1060,,Wolle,-1,18,20,47%,38,2023/04/14
914,1060,,Cash Finns,+1,13,11,54%,24,2023/04/07
915,1060,,Wywtigerking,+1,18,15,55%,33,2023/04/17
916,1060,,vulcanULTRA,+2,6,4,60%,10,2023/04/07
917,1060,,실망하지않을게,+1,31,29,52%,60,2023/04/08
918,1059,,Pour,+1,20,20,50%,40,2023/04/15
919,1059,,Tc||Driven2Chonk,-5,67,64,51%,131,2023/04/03
920,1059,,Advikato,-4,10,10,50%,20,2023/03/29
921,1058,,shz007,-2,32,28,53%,60,2023/04/09
922,1058,,SuppEngineer,+1,9,8,53%,17,2023/04/04
923,1058,,[KMLT]vado,-2,14,16,47%,30,2023/04/08
924,1058,,B3rr3x,+1,14,13,52%,27,2023/04/16
925,1058,,McLufi,-4,6,6,50%,12,2023/04/02
926,1058,,SteveMcQueef,+1,20,22,48%,42,2023/04/07
927,1057,,Alvat,+5,8,6,57%,14,2023/04/07
928,1057,,tobles,-1,20,17,54%,37,2023/03/25
929,1057,,Reemster,+1,9,8,53%,17,2023/03/21
930,1057,,Shadicar8,-1,18,15,55%,33,2023/04/13
931,1057,,limerick,-3,21,18,54%,39,2023/04/17
932,1057,,deinhard,+3,18,18,50%,36,2023/04/02
933,1057,,AutomaticAutocratic,-5,56,50,53%,106,2023/04/15
934,1056,,Dave,+1,15,15,50%,30,2023/04/13
935,1056,,Pepe Popo,+1,17,14,55%,31,2023/04/16
936,1056,,Smokezound,-3,55,49,53%,104,2023/03/28
937,1056,,I am not chinese,-1,12,10,55%,22,2023/04/15
938,1056,,SmauGG,+3,6,4,60%,10,2023/04/17
939,1056,,Lowang,-1,14,11,56%,25,2023/04/01
940,1056,,deneuve,+1,20,19,51%,39,2023/03/27
941,1055,,Crow,-2,21,22,49%,43,2023/04/08
942,1055,,Crovax,+2,6,5,55%,11,2023/04/09
943,1055,,◯ | Sillen,-1,10,8,56%,18,2023/04/12
944,1055,,Chairman Pan,-4,30,27,53%,57,2023/04/12
945,1055,,Heywood Jablowme,+1,9,10,47%,19,2023/04/06
946,1055,,CHINESE DO NOT SPEAK ENGLISH,-1,18,19,49%,37,2023/04/12
947,1055,,Schorschl,-2,13,14,48%,27,2023/04/16
948,1055,,renmeri,+1,30,26,54%,56,2023/04/13
949,1054,,Cozier Conch,+3,9,7,56%,16,2023/04/16
950,1054,,Marmelade,+2,6,5,55%,11,2023/04/14
951,1054,,大！,-1,50,49,51%,99,2023/04/05
952,1054,,TetrisRanger,-1,7,5,58%,12,2023/04/05
953,1054,,mickal21,-2,5,5,50%,10,2023/04/09
954,1054,,Temmie,-2,8,8,50%,16,2023/04/02
955,1054,,sarapowa,-1,29,34,46%,63,2023/04/11
956,1054,,General Feldsalat,-1,59,55,52%,114,2023/04/01
957,1054,,KiinG PurP,+2,91,91,50%,182,2023/04/17
958,1053,,Gluk Gluk 3000,+2,33,24,58%,57,2023/04/08
959,1053,,Benissimo,-1,6,4,60%,10,2023/04/17
960,1053,,Spartan_701,-1,8,6,57%,14,2023/03/28
961,1052,,【嗜血狼族】灵狐魅儿,+2,7,5,58%,12,2023/04/04
962,1052,,Max,-1,46,42,52%,88,2023/03/31
963,1052,,Cpt.Ray,-4,9,7,56%,16,2023/04/07
964,1051,,alionfried,-1,8,8,50%,16,2023/04/08
965,1051,,Angler Stein,+1,8,6,57%,14,2023/03/28
966,1051,,asado de perro,-2,18,17,51%,35,2023/04/17
967,1051,,PoppaMies,+6,31,30,51%,61,2023/04/16
968,1051,,sormi,-1,11,8,58%,19,2023/03/28
969,1051,,Brotherhood of noob,+1,17,15,53%,32,2023/03/30
970,1051,,Gauss2718,-2,56,54,51%,110,2023/04/06
971,1050,,poppe,-1,13,12,52%,25,2023/04/11
972,1050,,LeaKciM,+1,37,42,47%,79,2023/04/13
973,1050,,HIGH ON FALAFEL AND RICE,-3,43,49,47%,92,2023/03/31
974,1050,,月夜笑猫,-1,6,6,50%,12,2023/04/12
975,1050,,sheridanng,+1,35,33,51%,68,2023/04/17
976,1049,,jc5776,+1,14,13,52%,27,2023/04/07
977,1049,,Feier,+1,10,9,53%,19,2023/04/16
978,1049,,mistabojangles42,-3,30,29,51%,59,2023/03/31
979,1049,,Master_Baiter,-1,9,9,50%,18,2023/03/21
980,1049,,Mr. Samuel Arrow,+1,36,32,53%,68,2023/04/17
981,1049,,Jufflubagus,+5,13,10,57%,23,2023/03/31
982,1048,,iswtiger,-2,7,7,50%,14,2023/04/15
983,1048,,2nd Lt. Wilson [Ranger],-4,10,12,45%,22,2023/03/29
984,1048,,Kim Jong-un,+1,11,9,55%,20,2023/04/02
985,1048,,noluckystrike,-1,7,6,54%,13,2023/04/11
986,1047,,ViseBro,-2,33,26,56%,59,2023/03/30
987,1047,,MAZA_(Rus),+2,6,5,55%,11,2023/04/02
988,1047,,Socrates,-3,13,12,52%,25,2023/04/13
989,1047,,YOMAMMA,-2,36,34,51%,70,2023/04/17
990,1047,,theartisticpeanut,+2,16,17,48%,33,2023/03/25
991,1047,,[DPRK]DoGGiMan,+1,69,73,49%,142,2023/03/21
992,1047,,Naat,-2,5,5,50%,10,2023/03/28
993,1047,,MrGiio98,-1,14,12,54%,26,2023/04/14
994,1046,,Vedro_32,+1,15,15,50%,30,2023/03/24
995,1046,,ASWZ ScrotalLord,-1,7,6,54%,13,2023/04/02
996,1046,,Eki2,-1,53,50,51%,103,2023/04/17
997,1046,,Nylon,-2,7,7,50%,14,2023/04/12
998,1046,,shoopablaq,+1,50,50,50%,100,2023/04/13
999,1046,,Nostradamus,+2,10,8,56%,18,2023/04/09
1000,1045,,Dirty D,+1,16,16,50%,32,2023/04/14
1001,1045,,TheVVitcher,-1,6,5,55%,11,2023/03/23
1002,1045,,Raposa,+1,12,12,50%,24,2023/04/08
1003,1045,,Benevollus,+1,32,25,56%,57,2023/04/06
1004,1044,,Willyto,-1,22,26,46%,48,2023/04/14
1005,1044,,Pharmacist,-1,7,8,47%,15,2023/04/14
1006,1044,,Kaisor,-1,14,17,45%,31,2023/04/05
1007,1044,,tippman98x,+2,20,22,48%,42,2023/04/07
1008,1044,,Swol Team 6,-2,7,6,54%,13,2023/03/30
1009,1044,,rumor,+1,8,6,57%,14,2023/03/23
1010,1044,,dj,-2,6,5,55%,11,2023/04/09
1011,1043,,Gunny,-2,6,5,55%,11,2023/04/03
1012,1043,,CYBORGOR,+1,21,15,58%,36,2023/04/08
1013,1043,,NachoVidanal,-1,108,105,51%,213,2023/04/06
1014,1043,,JJs Juggernaut,+3,7,5,58%,12,2023/04/07
1015,1043,,HIMMLER,+1,9,7,56%,16,2023/04/07
1016,1042,,Major Storm,+1,14,10,58%,24,2023/04/03
1017,1042,,≡[EZGK]≡ T3dgO13,+2,9,8,53%,17,2023/03/24
1018,1042,,leonidas,-2,13,12,52%,25,2023/04/13
1019,1042,,iBaker,-1,14,15,48%,29,2023/04/15
1020,1042,,[2.FJg]Radroach -Schtz,+1,28,30,48%,58,2023/04/08
1021,1042,,Fain,-3,6,8,43%,14,2023/03/28
1022,1042,,[EXD] Ant,-3,51,46,53%,97,2023/04/17
1023,1042,,[DpS]Warlock,+5,6,4,60%,10,2023/04/17
1024,1041,,Clint Toastwood,-1,80,80,50%,160,2023/04/01
1025,1041,,Skreddern,-3,7,6,54%,13,2023/04/06
1026,1041,,Thunderguardian,-1,6,6,50%,12,2023/03/28
1027,1041,,Ashoka,+1,102,105,49%,207,2023/04/09
1028,1041,,justsoso,+3,19,15,56%,34,2023/04/08
1029,1041,,SkenZ,+1,13,13,50%,26,2023/04/16
1030,1041,,Ramen the Desert Noodle,-1,8,7,53%,15,2023/04/17
1031,1041,,Razvaljena-veverica,+2,5,5,50%,10,2023/04/08
1032,1040,,Der_Therapeut,-3,5,5,50%,10,2023/04/11
1033,1040,,darkyBRO,+1,61,57,52%,118,2023/04/17
1034,1040,,Seasoningmen,+1,6,7,46%,13,2023/04/02
1035,1040,,Goblin,+2,8,7,53%,15,2023/04/06
1036,1040,,Temujin,-2,14,14,50%,28,2023/03/31
1037,1040,,Bavarian Slice,-2,8,8,50%,16,2023/03/26
1038,1040,,Ranger,+2,24,27,47%,51,2023/04/17
1039,1040,,FluffyNoStrat,-3,14,15,48%,29,2023/04/10
1040,1040,,Anhangá,-2,27,26,51%,53,2023/04/11
1041,1039,,Bastión I,+2,9,8,53%,17,2023/04/18
1042,1039,,LMAA||Powerpeter,-4,29,35,45%,64,2023/04/10
1043,1039,,WazzaBozza,-1,10,9,53%,19,2023/04/15
1044,1039,,karl,+1,35,37,49%,72,2023/04/14
1045,1038,,OdinsChosen,-1,24,21,53%,45,2023/04/02
1046,1038,,Lahire PL,-3,5,7,42%,12,2023/04/03
1047,1038,,Jeffsl,+2,40,35,53%,75,2023/04/13
1048,1038,,Sev,-1,16,11,59%,27,2023/03/27
1049,1037,,Kapitalistischer Karl Marx,-1,5,5,50%,10,2023/03/24
1050,1037,,Tato,-1,32,27,54%,59,2023/04/14
1051,1037,,Xyr1n,-1,6,5,55%,11,2023/04/11
1052,1037,,Meowe,-4,6,6,50%,12,2023/04/06
1053,1037,,Fallen Ghost,+1,5,5,50%,10,2023/04/01
1054,1037,,jeepdrivertomnay,+1,21,18,54%,39,2023/04/16
1055,1037,,Cen,+1,10,9,53%,19,2023/04/12
1056,1036,,Dranu,-4,10,11,48%,21,2023/04/11
1057,1036,,Sercodttv,+1,8,8,50%,16,2023/04/02
1058,1036,,Hetzkopp,+3,8,6,57%,14,2023/04/09
1059,1036,,Mpeezy,-2,8,7,53%,15,2023/04/15
1060,1036,,Wonsaty Szlachcic,-3,6,5,55%,11,2023/04/07
1061,1036,,Aparoid96,+4,7,5,58%,12,2023/04/02
1062,1036,,Dezza,-1,5,5,50%,10,2023/03/30
1063,1036,,ihanrii,+2,5,5,50%,10,2023/04/09
1064,1036,,RogueTrooper34,+1,14,12,54%,26,2023/04/04
1065,1035,,bisivan1,-1,17,17,50%,34,2023/04/17
1066,1035,,EvocatusMajin,+1,69,74,48%,143,2023/04/17
1067,1035,,Wurstzipfl,+1,7,6,54%,13,2023/04/05
1068,1035,,Ol'Smokey,-1,56,55,50%,111,2023/04/12
1069,1035,,クiズiマ,+1,59,56,51%,115,2023/03/28
1070,1034,,amateur shut in,-2,32,31,51%,63,2023/04/18
1071,1034,,ManBearPig,+2,40,42,49%,82,2023/04/08
1072,1034,,Mondieu the puffin,-2,37,35,51%,72,2023/04/09
1073,1034,,Kronkers,+1,6,6,50%,12,2023/04/06
1074,1034,,快乐树骑士团,+1,8,7,53%,15,2023/04/17
1075,1034,,Doc Holliday,+1,17,19,47%,36,2023/04/17
1076,1034,,AAA,-1,12,14,46%,26,2023/04/07
1077,1033,,Freezer,-2,5,5,50%,10,2023/04/08
1078,1033,,niewiem94851,-1,7,7,50%,14,2023/04/14
1079,1033,,烧花鸭烧雏鸡儿烧子鹅,+3,15,15,50%,30,2023/04/16
1080,1032,,Vettlen,+1,9,8,53%,17,2023/04/17
1081,1032,,KampfLachs,-4,21,21,50%,42,2023/04/13
1082,1032,,shobbs001,-2,48,37,56%,85,2023/04/09
1083,1032,,BILBOBUSSINS,+1,28,28,50%,56,2023/04/04
1084,1032,,Till Forever Falls Apart,+2,9,7,56%,16,2023/04/03
1085,1032,,MichaelOyster,-2,13,11,54%,24,2023/04/09
1086,1032,,tizuswang,+3,11,10,52%,21,2023/04/02
1087,1031,,OFG_LUB,-2,19,18,51%,37,2023/03/29
1088,1031,,Blarg_Master,-1,9,11,45%,20,2023/04/07
1089,1031,,Smartie,-2,10,9,53%,19,2023/04/05
1090,1031,,Centurion,-3,7,9,44%,16,2023/04/02
1091,1031,,Astersia,-1,20,23,47%,43,2023/04/14
1092,1031,,Shockz,+2,27,29,48%,56,2023/04/12
1093,1030,,Chu,-1,7,7,50%,14,2023/04/13
1094,1030,,comrade14andrei,-3,13,17,43%,30,2023/04/07
1095,1030,,Gravemouth,+4,25,29,46%,54,2023/04/03
1096,1030,,Eccle,-1,22,25,47%,47,2023/04/17
1097,1030,,kat,-1,5,6,45%,11,2023/04/17
1098,1030,,Rezkin-Gurh,+1,8,8,50%,16,2023/04/11
1099,1029,,Heyman,-2,6,6,50%,12,2023/03/25
1100,1029,,BGJ,-2,33,30,52%,63,2023/04/09
1101,1029,,Toeran,-1,31,28,53%,59,2023/04/14
1102,1029,,Armless Guy Gaming,+1,26,23,53%,49,2023/04/05
1103,1029,,Lookingforabettername,+1,6,6,50%,12,2023/03/26
1104,1029,,qinlang70,-2,6,6,50%,12,2023/04/15
1105,1029,,AHungryPigeon,-2,5,5,50%,10,2023/03/26
1106,1029,,lappodamy,+2,20,17,54%,37,2023/04/17
1107,1028,,CallmeRupert,+1,6,5,55%,11,2023/03/21
1108,1028,,Enlightened Enlisted,+1,10,10,50%,20,2023/03/24
1109,1028,,bedolejsi,-4,5,7,42%,12,2023/04/09
1110,1028,,ryuklikesapples,-4,24,24,50%,48,2023/04/08
1111,1028,,chris nos,+1,24,24,50%,48,2023/04/17
1112,1028,,belmax,+2,9,9,50%,18,2023/04/05
1113,1027,,Insignia,+3,44,43,51%,87,2023/04/02
1114,1027,,deanx1,+1,176,191,48%,367,2023/04/14
1115,1027,,headRaZzor,+4,10,8,56%,18,2023/04/03
1116,1027,,Reshala,-1,12,11,52%,23,2023/03/23
1117,1027,,socif,-3,45,44,51%,89,2023/04/17
1118,1027,,MacP,-2,12,12,50%,24,2023/04/08
1119,1027,,Hui,-1,18,16,53%,34,2023/04/15
1120,1027,,Nacho Fan Sandy Ravage,+1,9,8,53%,17,2023/04/14
1121,1027,,misterbeige,-2,10,9,53%,19,2023/04/14
1122,1027,,mocik(PL),-2,5,5,50%,10,2023/04/05
1123,1026,,Kampfgruppe Lehr,-4,9,10,47%,19,2023/03/28
1124,1026,,schorrock,+4,15,12,56%,27,2023/03/24
1125,1026,,Decs,+1,27,23,54%,50,2023/04/17
1126,1025,,Ladabaz,+2,14,12,54%,26,2023/03/22
1127,1025,,Nazca,-3,19,19,50%,38,2023/04/17
1128,1024,,Acidfenix,+2,9,9,50%,18,2023/04/06
1129,1024,,oxfordsdon,-2,5,5,50%,10,2023/04/02
1130,1024,,Inari96,+1,6,6,50%,12,2023/04/08
1131,1024,,Ataf,-1,34,35,49%,69,2023/04/07
1132,1024,,offmask,-2,9,8,53%,17,2023/04/08
1133,1024,,Butter0185,+1,23,23,50%,46,2023/04/16
1134,1023,,Azely,+1,16,13,55%,29,2023/04/16
1135,1023,,LanceBenz,+1,6,6,50%,12,2023/04/01
1136,1023,,oh2009,+1,275,278,50%,553,2023/04/18
1137,1023,,Nello the Tiger,+2,31,30,51%,61,2023/04/05
1138,1022,,Observing Potato,+2,6,5,55%,11,2023/03/26
1139,1022,,GypsyCatcher,-1,9,12,43%,21,2023/04/04
1140,1022,,Donald Trumps Wall,-2,7,7,50%,14,2023/04/08
1141,1022,,An.t,+4,29,28,51%,57,2023/03/29
1142,1022,,Ligi,+1,10,11,48%,21,2023/03/26
1143,1022,,[DK] KrigerKris,-1,14,15,48%,29,2023/04/02
1144,1022,,liaroyffs,+3,6,4,60%,10,2023/03/24
1145,1021,,Morthe1st,+4,8,8,50%,16,2023/04/10
1146,1021,,DR4GU,-6,8,10,44%,18,2023/04/17
1147,1021,,Erwin Rommel,-3,5,5,50%,10,2023/04/06
1148,1021,,GhettoschinkenDeluxe,+1,8,9,47%,17,2023/04/06
1149,1021,,Cory The Gardener,+1,6,7,46%,13,2023/04/13
1150,1021,,Croaker,-2,14,17,45%,31,2023/04/16
1151,1020,,NIVEA,+1,15,19,44%,34,2023/04/09
1152,1020,,wladimir edelweiß,-3,9,13,41%,22,2023/04/04
1153,1020,,Likes,+1,8,8,50%,16,2023/04/07
1154,1020,,Senator Armstrong,-2,28,26,52%,54,2023/04/16
1155,1020,,ironicusername17,-1,38,37,51%,75,2023/04/15
1156,1020,,jonax,-1,9,10,47%,19,2023/04/09
1157,1019,,Amkkiller,+1,13,13,50%,26,2023/03/25
1158,1019,,cellardoor,-5,8,8,50%,16,2023/03/31
1159,1019,,Ashlande,-2,22,20,52%,42,2023/04/03
1160,1019,,SkuldMeowMeow,+1,20,17,54%,37,2023/04/01
1161,1019,,麥尬武村,+1,14,12,54%,26,2023/03/26
1162,1019,,Trampoliere,-1,8,6,57%,14,2023/04/04
1163,1018,,Goodvyn,-1,39,38,51%,77,2023/04/09
1164,1018,,max,+5,22,17,56%,39,2023/03/23
1165,1018,,Boss Of This Gym,+2,36,35,51%,71,2023/04/04
1166,1017,,BENTHEGARBAGEMAN,+1,51,53,49%,104,2023/03/25
1167,1017,,Kersal,-6,10,12,45%,22,2023/04/11
1168,1017,,aurri,+3,30,35,46%,65,2023/04/12
1169,1017,,Flint_Beastwood,-2,7,8,47%,15,2023/04/02
1170,1016,,ironknee89,-3,95,96,50%,191,2023/04/17
1171,1016,,Thraz,+2,9,8,53%,17,2023/04/03
1172,1016,,Talion The Tark,-2,14,20,41%,34,2023/04/15
1173,1016,,destroyed world,-1,6,7,46%,13,2023/04/09
1174,1016,,Röde Orm,-2,20,18,53%,38,2023/04/11
1175,1016,,kaigem43,+1,34,35,49%,69,2023/04/13
1176,1016,,Jesus's Cream,+1,17,15,53%,32,2023/03/28
1177,1015,,peace,-2,15,19,44%,34,2023/04/16
1178,1015,,Large,-3,17,17,50%,34,2023/04/17
1179,1015,,GUILLOTINE,-1,46,41,53%,87,2023/04/09
1180,1015,,codiece,+2,12,11,52%,23,2023/04/07
1181,1015,,Delta™,-1,93,90,51%,183,2023/04/17
1182,1015,,Frutton,-1,5,5,50%,10,2023/04/17
1183,1015,,daDomsenca,+1,7,7,50%,14,2023/04/03
1184,1014,,snekasan,+4,15,16,48%,31,2023/04/11
1185,1014,,Gekko,+2,18,15,55%,33,2023/04/17
1186,1014,,La Crevette,-4,29,36,45%,65,2023/04/12
1187,1014,,Madner,+5,12,8,60%,20,2023/04/12
1188,1014,,Janri Costava,+1,5,5,50%,10,2023/04/13
1189,1014,,Legion707,-2,5,6,45%,11,2023/04/17
1190,1014,,Charles_XII,+2,38,38,50%,76,2023/04/15
1191,1014,,Swedish Moose,-3,6,7,46%,13,2023/03/25
1192,1014,,Louis_XJ,+1,9,9,50%,18,2023/04/17
1193,1013,,BodenWaffe,+1,6,6,50%,12,2023/04/04
1194,1013,,ADOLFO_CABRERA,-1,7,6,54%,13,2023/04/17
1195,1013,,PhantomErection,+7,20,18,53%,38,2023/04/11
1196,1012,,Raz el Hanout,+2,29,28,51%,57,2023/04/16
1197,1012,,Kenan,+2,6,6,50%,12,2023/04/07
1198,1012,,WadoVice,+1,39,41,49%,80,2023/04/12
1199,1012,,Brick-A-ttack,-2,11,11,50%,22,2023/04/16
1200,1012,,macdaddy!,+1,17,16,52%,33,2023/04/10
1201,1011,,Weisswolf,-1,28,23,55%,51,2023/04/14
1202,1011,,NorthWestFresh,+2,36,36,50%,72,2023/04/16
1203,1011,,Uncle Soekarno,-1,11,12,48%,23,2023/04/06
1204,1011,,Potbelly Goblin Hunter,+1,14,14,50%,28,2023/04/10
1205,1011,,NiW,+1,9,10,47%,19,2023/04/16
1206,1011,,Riis,-2,6,5,55%,11,2023/04/15
1207,1011,,Dr.Sillee,+1,10,9,53%,19,2023/03/31
1208,1010,,asteelec,+5,11,9,55%,20,2023/04/04
1209,1010,,pomegranate,-2,7,6,54%,13,2023/04/11
1210,1010,,sprexnico,+2,38,38,50%,76,2023/04/15
1211,1010,,madhax,+3,9,8,53%,17,2023/04/16
1212,1010,,CRAWLER,-1,19,19,50%,38,2023/04/08
1213,1009,,sakul,-3,12,12,50%,24,2023/04/15
1214,1009,,new6oot9oofin,+2,7,6,54%,13,2023/03/25
1215,1009,,Psychomantis.PANG,+1,8,9,47%,17,2023/04/17
1216,1009,,Asdasfad.,+4,7,6,54%,13,2023/04/02
1217,1009,,Billy the Kid,-1,6,5,55%,11,2023/04/04
1218,1009,,[xtc]Luckyday,-2,5,5,50%,10,2023/03/30
1219,1009,,minty,-1,23,21,52%,44,2023/04/03
1220,1008,,L,+1,97,102,49%,199,2023/04/18
1221,1008,,Mr. Negative,-1,5,5,50%,10,2023/03/21
1222,1008,,AdmiralAmerica,-2,5,5,50%,10,2023/03/22
1223,1008,,Imagodei,-1,19,17,53%,36,2023/04/16
1224,1008,,KKanBu,-4,7,8,47%,15,2023/04/08
1225,1008,,STAX RTY,+1,12,11,52%,23,2023/04/03
1226,1008,,EastHawk,-3,13,14,48%,27,2023/04/13
1227,1008,,arthurdesmedt,-1,7,6,54%,13,2023/04/03
1228,1008,,eybe,-5,5,6,45%,11,2023/04/07
1229,1008,,Punkass Beach,+1,20,23,47%,43,2023/03/30
1230,1008,,BulbousBow,-6,19,24,44%,43,2023/04/06
1231,1008,,Vichunt_st,+1,8,9,47%,17,2023/04/08
1232,1008,,Camillus,-3,9,10,47%,19,2023/04/08
1233,1007,,jinkmoon2,-2,17,18,49%,35,2023/04/13
1234,1007,,Look! A Distraction!,+1,5,6,45%,11,2023/04/16
1235,1007,,88jpmm,+4,46,50,48%,96,2023/04/06
1236,1007,,SovietBuffalo,-2,15,19,44%,34,2023/04/16
1237,1007,,Veli,+1,32,31,51%,63,2023/04/17
1238,1007,,JULIUS,-3,11,13,46%,24,2023/04/13
1239,1007,,李晴天,+2,7,8,47%,15,2023/04/11
1240,1006,,Wild-Muffin,-1,35,31,53%,66,2023/04/17
1241,1006,,鸡脚芝士,-1,44,49,47%,93,2023/03/31
1242,1006,,老艺术家,-3,5,6,45%,11,2023/04/07
1243,1006,,Hello,+1,5,5,50%,10,2023/04/14
1244,1005,,Victorforce Alpha,+1,11,8,58%,19,2023/04/10
1245,1005,,Calxtus,+2,8,6,57%,14,2023/04/01
1246,1005,,PolanStronk,+1,14,13,52%,27,2023/04/10
1247,1005,,Autumn of Winter,+1,17,20,46%,37,2023/04/10
1248,1005,,sergzurita,-1,5,5,50%,10,2023/04/13
1249,1005,,ForFreedom,+3,10,10,50%,20,2023/04/17
1250,1004,,Arhok,+1,13,11,54%,24,2023/04/16
1251,1004,,BA_Flesh_WounD,-2,8,6,57%,14,2023/04/09
1252,1004,,SmeltedElk,-1,7,8,47%,15,2023/04/04
1253,1004,,Arres,-2,5,7,42%,12,2023/04/17
1254,1004,,gman5555555555,+1,10,10,50%,20,2023/04/15
1255,1004,,LIJ ROMMEL,-2,13,13,50%,26,2023/04/16
1256,1004,,All Day,-1,11,12,48%,23,2023/04/17
1257,1003,,Hanger,-2,8,8,50%,16,2023/04/11
1258,1003,,rocketpossum,-1,5,6,45%,11,2023/04/17
1259,1002,,Charlie,+1,6,6,50%,12,2023/03/30
1260,1002,,LikioOo,+2,19,14,58%,33,2023/04/16
1261,1002,,=★= Iron Hawk =★=,-2,29,29,50%,58,2023/04/16
1262,1002,,OldGlory,+3,7,5,58%,12,2023/04/04
1263,1002,,Chank Bulkhead,+1,29,30,49%,59,2023/04/08
1264,1001,,Sgt.DasheRRR,+1,38,35,52%,73,2023/04/17
1265,1001,,sno^,-2,63,62,50%,125,2023/04/14
1266,1001,,Saturas,-2,7,9,44%,16,2023/04/09
1267,1001,,Jacob,+1,6,5,55%,11,2023/04/15
1268,1001,,GvardiA,+2,16,17,48%,33,2023/04/05
1269,1001,,john.voyage,+1,7,7,50%,14,2023/04/05
1270,1001,,Tw_Yolin,+1,52,56,48%,108,2023/04/17
1271,1001,,KingSeamus,+1,12,12,50%,24,2023/03/25
1272,1001,,WhiteWhale42,-2,5,5,50%,10,2023/03/30
1273,1000,,Poomaster09,-3,62,63,50%,125,2023/04/11
1274,1000,,PGLee,+1,6,5,55%,11,2023/04/17
1275,1000,,Berkilius,+1,17,17,50%,34,2023/04/17
1276,1000,,无声狂啸,-3,5,7,42%,12,2023/04/14
1277,999,,Kimin,+1,40,42,49%,82,2023/04/09
1278,999,,SenkZ,-1,19,17,53%,36,2023/04/13
1279,999,,камазик,-1,24,23,51%,47,2023/04/08
1280,999,,Celogalileo,-1,11,12,48%,23,2023/03/22
1281,999,,thaNästy,-1,13,14,48%,27,2023/04/01
1282,999,,Lieutenant Guy,+2,10,11,48%,21,2023/04/11
1283,999,,awokeN 1904.,-3,7,8,47%,15,2023/04/13
1284,999,,Pretoryan,+2,6,5,55%,11,2023/04/17
1285,999,,superyaought,+3,6,5,55%,11,2023/03/22
1286,999,,TTONAK,-1,8,10,44%,18,2023/04/06
1287,998,,[14e]tuveuxdugateaux,-1,42,34,55%,76,2023/03/23
1288,998,,Crucial Deluxe,+1,18,15,55%,33,2023/04/13
1289,998,,Skillman,-1,25,26,49%,51,2023/03/30
1290,998,,jordanglez97,-1,6,7,46%,13,2023/04/03
1291,998,,phobia,-5,49,54,48%,103,2023/04/14
1292,998,,Firestorm,+1,5,5,50%,10,2023/04/06
1293,997,,大力出奇迹,-2,16,17,48%,33,2023/04/06
1294,997,,C. Troy,+2,6,5,55%,11,2023/03/26
1295,997,,Dick Kickem,-1,25,28,47%,53,2023/04/12
1296,997,,WinRar Trial,-1,6,7,46%,13,2023/04/07
1297,997,,vsatanner,-3,23,25,48%,48,2023/04/17
1298,997,,Beans,-3,5,5,50%,10,2023/04/17
1299,997,,rarehunter_dark,-2,5,5,50%,10,2023/04/04
1300,997,,Flower,+2,5,5,50%,10,2023/03/23
1301,997,,The Real Green,+1,5,5,50%,10,2023/04/06
1302,997,,2Beer / Schrimp,-1,20,22,48%,42,2023/04/15
1303,997,,Bäckis,+1,11,15,42%,26,2023/04/17
1304,997,,Empire,-1,10,11,48%,21,2023/03/28
1305,997,,Brightsite,+1,6,6,50%,12,2023/04/09
1306,997,,Bears Beets,-1,25,25,50%,50,2023/03/31
1307,997,,Mr. Jor,-2,16,19,46%,35,2023/04/09
1308,997,,MrBust,+1,11,12,48%,23,2023/04/04
1309,996,,da.zigounet,-2,82,85,49%,167,2023/04/17
1310,996,,TheMangles,+1,15,12,56%,27,2023/04/17
1311,995,,KC,-1,22,19,54%,41,2023/03/31
1312,995,,Aloxos el Boloss,-4,10,12,45%,22,2023/04/13
1313,995,,Antiunfall,-2,10,12,45%,22,2023/04/17
1314,995,,Spitfire,+2,52,58,47%,110,2023/04/05
1315,995,,DizzyWaters,-1,5,6,45%,11,2023/04/03
1316,995,,ryanpetro,-3,5,5,50%,10,2023/03/21
1317,995,,Percevl84,-1,11,12,48%,23,2023/04/17
1318,994,,witrilix,+1,24,28,46%,52,2023/04/12
1319,994,,Old Rebel,+3,10,10,50%,20,2023/03/23
1320,994,,FitzBro,-5,18,17,51%,35,2023/03/31
1321,994,,Menfis,+2,12,11,52%,23,2023/04/18
1322,994,,yaacob,-3,28,33,46%,61,2023/04/17
1323,994,,luckyes63,-1,11,11,50%,22,2023/04/16
1324,994,,kitoune,-1,18,18,50%,36,2023/04/13
1325,993,,Frangerhawer,-1,5,5,50%,10,2023/04/08
1326,992,,Panther Vor Doctrine,-1,7,8,47%,15,2023/04/17
1327,992,,heybuy,-3,5,5,50%,10,2023/04/03
1328,992,,Povke,+1,28,27,51%,55,2023/04/13
1329,992,,Daniel Gaming,-1,10,11,48%,21,2023/04/08
1330,991,,clepic42,-1,6,6,50%,12,2023/03/27
1331,991,,Commissar500,+1,8,9,47%,17,2023/04/15
1332,991,,A Sociopath,-3,5,5,50%,10,2023/04/01
1333,991,,DanceFKRdance,+1,30,32,48%,62,2023/04/14
1334,990,,HeldohneNamen,-3,10,14,42%,24,2023/04/06
1335,990,,Scaltro,+1,6,7,46%,13,2023/04/12
1336,990,,Cpt.Crunch,-1,13,14,48%,27,2023/04/07
1337,990,,sebeck,+1,22,19,54%,41,2023/04/17
1338,989,,ArmhairGeneral,+2,11,11,50%,22,2023/04/06
1339,989,,MeowMeowKungPow,+1,7,6,54%,13,2023/04/17
1340,989,,the doctor,-3,9,11,45%,20,2023/04/13
1341,989,,Hasdafu,-1,6,7,46%,13,2023/03/28
1342,989,,Daneruid,+4,14,14,50%,28,2023/04/14
1343,989,,C-SkyIIAtzeII,+1,5,6,45%,11,2023/03/31
1344,989,,_Ragnar_Lothbrok__,-1,9,9,50%,18,2023/04/09
1345,989,,Bartolini ce,+2,8,9,47%,17,2023/04/17
1346,989,,Neuromancer,+2,13,15,46%,28,2023/04/15
1347,989,,Ryūk7,+2,9,9,50%,18,2023/03/25
1348,989,,Xegul,+3,11,12,48%,23,2023/04/14
1349,988,,Dreamerpython,-3,9,10,47%,19,2023/03/29
1350,988,,Crixuz,-4,8,10,44%,18,2023/03/21
1351,988,,Hobofingers,+2,7,7,50%,14,2023/04/16
1352,988,,I_Lov_Anime_Titties,+3,11,10,52%,21,2023/04/11
1353,988,,是铁头先生呀~~,-2,8,10,44%,18,2023/04/11
1354,988,,MysteryRanch79,+2,8,7,53%,15,2023/04/02
1355,987,,schwufti Schwuft,-1,11,12,48%,23,2023/03/23
1356,987,,Wild-Muffin,-2,35,32,52%,67,2023/04/18
1357,987,,UNHOLY GOALIE,-1,7,6,54%,13,2023/04/07
1358,987,,pandabear2301,-2,5,6,45%,11,2023/03/28
1359,987,,Racknagor,-1,41,36,53%,77,2023/04/18
1360,987,,Washington Irving,-1,15,18,45%,33,2023/04/05
1361,987,,Top G-liath,-4,33,30,52%,63,2023/04/08
1362,987,,Dayobi,+1,5,5,50%,10,2023/04/09
1363,987,,King Frustrated,-1,68,70,49%,138,2023/03/30
1364,986,,Trigger,+1,5,7,42%,12,2023/03/25
1365,986,,Ranulfus,-2,9,11,45%,20,2023/04/15
1366,986,,DirtMcGirt,-1,15,15,50%,30,2023/04/16
1367,986,,sharp24,+1,25,24,51%,49,2023/04/12
1368,986,,The Anti-Liberal,-2,6,7,46%,13,2023/04/14
1369,986,,Saryn,-2,31,32,49%,63,2023/03/23
1370,986,,D3LT4,+2,43,39,52%,82,2023/04/16
1371,986,,Bazza from Coffs,+1,7,8,47%,15,2023/03/28
1372,985,,JagerNutts,-2,5,6,45%,11,2023/04/14
1373,985,,JinkelaBoss,+5,19,18,51%,37,2023/04/17
1374,985,,Fuminator,+1,15,14,52%,29,2023/04/15
1375,985,,Staufenberg,-1,13,12,52%,25,2023/04/15
1376,985,,ANDOGNNI,-5,32,37,46%,69,2023/03/28
1377,985,,Micro,+1,14,16,47%,30,2023/04/16
1378,985,,Bugle Dog,-1,38,40,49%,78,2023/04/15
1379,984,,Nanshinner,+2,18,27,40%,45,2023/04/17
1380,984,,Greeno6,+3,6,6,50%,12,2023/03/28
1381,984,,Trenton,-3,6,9,40%,15,2023/03/30
1382,984,,JayT,+3,6,6,50%,12,2023/03/26
1383,984,,Harinezumi,+1,5,7,42%,12,2023/04/08
1384,983,,Aerozeppelin,+1,46,50,48%,96,2023/04/17
1385,983,,OhSnap,+1,16,13,55%,29,2023/04/14
1386,983,,osdann99,+1,12,13,48%,25,2023/04/15
1387,983,,☼ Astinus ☼,+5,10,10,50%,20,2023/04/16
1388,982,,Sir Toady,-2,18,21,46%,39,2023/03/30
1389,982,,861606598,+1,6,6,50%,12,2023/03/27
1390,982,,William J,-1,8,8,50%,16,2023/04/08
1391,981,,pipboy,-4,79,78,50%,157,2023/04/11
1392,981,,DardL,-2,5,6,45%,11,2023/04/13
1393,981,,LotDExile,-2,6,8,43%,14,2023/04/16
1394,981,,Ace D. Brokenwing,+1,10,14,42%,24,2023/04/16
1395,981,,MarsAttacks,+2,37,36,51%,73,2023/03/26
1396,981,,Saint Michael,+5,30,29,51%,59,2023/04/18
1397,981,,Voodoo Mama JuJu,-4,7,11,39%,18,2023/04/02
1398,981,,DK,+6,13,12,52%,25,2023/04/07
1399,981,,PrinzIgor,-2,16,19,46%,35,2023/03/28
1400,980,,Karthago,-6,11,14,44%,25,2023/04/05
1401,980,,{Eliote Le Pilote},+2,22,21,51%,43,2023/04/02
1402,980,,Dutch-Ace,-1,5,6,45%,11,2023/03/23
1403,980,,국스,+1,7,8,47%,15,2023/04/17
1404,980,,General Scales,-2,8,8,50%,16,2023/04/16
1405,980,,二条院羽月,-2,11,14,44%,25,2023/04/16
1406,980,,KING,-1,24,18,57%,42,2023/04/18
1407,980,,RadialEngine,-2,11,12,48%,23,2023/04/16
1408,980,,ARMAGEDDON_BETWEENER,+1,72,70,51%,142,2023/04/17
1409,979,,JBossch,+2,8,7,53%,15,2023/04/17
1410,979,,ryad1,+2,18,19,49%,37,2023/04/10
1411,979,,Niloc,+5,7,6,54%,13,2023/04/15
1412,979,,luggi723,-3,9,12,43%,21,2023/04/16
1413,979,,Crash Override,-2,116,111,51%,227,2023/04/17
1414,979,,Marmalade,+2,26,29,47%,55,2023/04/14
1415,979,,Frouther,+1,6,7,46%,13,2023/04/11
1416,979,,Wahuhi,-2,8,9,47%,17,2023/04/04
1417,978,,Ygod,+2,5,7,42%,12,2023/03/26
1418,978,,A. Black [29th ID],+1,24,21,53%,45,2023/04/12
1419,978,,Tucker Carlson's Hair Piece,+3,8,7,53%,15,2023/04/15
1420,977,,Paper Cipher,-4,5,6,45%,11,2023/03/29
1421,977,,Hans_Hackfresse,-3,13,15,46%,28,2023/04/08
1422,977,,Mook Spits,+1,6,7,46%,13,2023/03/31
1423,977,,Tsoi,-1,5,5,50%,10,2023/04/15
1424,977,,Tw!sT,-1,12,15,44%,27,2023/04/02
1425,977,,Kryptonos,-3,32,32,50%,64,2023/04/17
1426,977,,KingdomKobra,-1,7,9,44%,16,2023/03/26
1427,977,,AC_Baldo,+2,7,7,50%,14,2023/04/16
1428,977,,Nitroman,-2,9,17,35%,26,2023/04/12
1429,977,,Mad Cow,+1,26,25,51%,51,2023/04/15
1430,977,,W4RFIGH7ER,+1,14,13,52%,27,2023/04/14
1431,976,,Kaiser Soze,+3,10,10,50%,20,2023/04/10
1432,976,,Bouda,-1,6,6,50%,12,2023/04/11
1433,976,,pasuco,+2,6,6,50%,12,2023/04/08
1434,976,,Pille,-1,11,14,44%,25,2023/04/14
1435,975,,Rakkammecc,-3,12,12,50%,24,2023/04/06
1436,975,,HawkslyTW,+1,16,16,50%,32,2023/04/05
1437,975,,The Miracle,+3,10,11,48%,21,2023/04/15
1438,975,,alex_fanyman,+1,12,17,41%,29,2023/03/30
1439,974,,t_ceezy,-6,6,8,43%,14,2023/03/22
1440,974,,사막맛살,-3,12,16,43%,28,2023/04/14
1441,974,,McCurtis,+4,15,12,56%,27,2023/04/06
1442,973,,Ariel,-4,25,31,45%,56,2023/03/23
1443,973,,BleedDiggiD,+1,5,5,50%,10,2023/04/11
1444,973,,lichung_yu,+1,9,10,47%,19,2023/04/01
1445,973,,NotableComic,-3,4,6,40%,10,2023/03/25
1446,973,,tonyma845,+1,44,49,47%,93,2023/04/03
1447,972,,erectusapes,+1,12,15,44%,27,2023/04/15
1448,972,,weizen.nilas,+1,8,10,44%,18,2023/04/02
1449,972,,CDCusa,+1,7,8,47%,15,2023/04/09
1450,972,,AF2006,+2,11,10,52%,21,2023/04/09
1451,972,,Shinjo 01ㄨ,+2,26,21,55%,47,2023/04/15
1452,971,,Hartek(US),-5,7,10,41%,17,2023/04/15
1453,971,,Mixrundiy,-5,7,10,41%,17,2023/03/28
1454,971,,Shraken,-6,9,13,41%,22,2023/03/28
1455,971,,bwl66720,+2,25,20,56%,45,2023/04/07
1456,971,,Emperor Meiji,-1,43,44,49%,87,2023/04/06
1457,971,,burble5,-4,5,8,38%,13,2023/04/05
1458,971,,Corelegend,-1,55,53,51%,108,2023/04/12
1459,971,,Dur3X,-5,4,6,40%,10,2023/04/11
1460,970,,MeisterPopko,+1,9,11,45%,20,2023/04/04
1461,970,,SirotiMajmun,-4,6,10,38%,16,2023/04/08
1462,970,,TW sss40405,-1,10,10,50%,20,2023/04/03
1463,970,,Hum$nRights,+2,6,6,50%,12,2023/03/26
1464,970,,Josh,-2,18,22,45%,40,2023/04/03
1465,970,,SOSO,+5,87,88,50%,175,2023/04/17
1466,970,,Carcosa,-2,6,7,46%,13,2023/03/25
1467,970,,Anchovy,+3,20,20,50%,40,2023/04/11
1468,969,,Desaya,+1,64,57,53%,121,2023/04/17
1469,969,,Slayaro,-1,7,8,47%,15,2023/03/31
1470,968,,acn322,-2,10,12,45%,22,2023/03/25
1471,968,,ŞişirmeKadam,-2,7,8,47%,15,2023/03/25
1472,968,,-p,-2,19,21,48%,40,2023/03/21
1473,968,,tanne455,-1,32,35,48%,67,2023/04/16
1474,968,,Kanonenvogel,-1,20,22,48%,42,2023/04/14
1475,968,,EsP _NieTO,-2,5,7,42%,12,2023/04/08
1476,968,,LukasGruber2409,-1,4,6,40%,10,2023/03/28
1477,968,,Sher,-5,92,98,48%,190,2023/04/17
1478,968,,Schmez,-3,6,9,40%,15,2023/03/30
1479,967,,PZG ORDER,+1,38,40,49%,78,2023/04/12
1480,967,,Von Wolfenbüttel,+3,6,6,50%,12,2023/04/13
1481,967,,Dr.Draese,-1,6,6,50%,12,2023/04/03
1482,967,,Freydal,-1,27,34,44%,61,2023/04/15
1483,966,,Bobblehead,-1,39,37,51%,76,2023/04/15
1484,966,,唐,+1,28,35,44%,63,2023/04/15
1485,966,,bigcomfypillow,+1,10,11,48%,21,2023/04/10
1486,966,,Fat Samurai,+1,5,7,42%,12,2023/04/10
1487,966,,Studano,+2,11,10,52%,21,2023/04/14
1488,965,,大英帝国第六步兵师,+3,20,20,50%,40,2023/04/04
1489,965,,Malme,+5,7,6,54%,13,2023/04/15
1490,965,,thepaleking,-1,5,6,45%,11,2023/03/27
1491,965,,Singularity,-1,28,22,56%,50,2023/04/04
1492,965,,coori,-1,5,7,42%,12,2023/04/10
1493,964,,Nuclear Whale,+2,21,22,49%,43,2023/04/13
1494,964,,Snopel,+2,19,16,54%,35,2023/03/30
1495,963,,PartTime_RebeL,-1,12,15,44%,27,2023/04/18
1496,963,,thorvaldmjolnir,-1,42,43,49%,85,2023/04/03
1497,963,,RN42,+1,28,28,50%,56,2023/04/13
1498,963,,Heizenberg,-9,32,35,48%,67,2023/04/06
1499,963,,raatemsholosti,-1,21,21,50%,42,2023/04/10
1500,963,,Arre,+1,10,12,45%,22,2023/03/29
1501,963,,JAR JAR BINKS,-3,4,6,40%,10,2023/03/29
1502,962,,Nubbl0r,+1,50,52,49%,102,2023/04/15
1503,962,,MadeManG74,-3,14,18,44%,32,2023/03/29
1504,962,,犬,+3,150,152,50%,302,2023/04/16
1505,962,,BRUTAL † HORDE,+1,91,100,48%,191,2023/04/17
1506,962,,DoubleBarrelShogun,-5,5,8,38%,13,2023/04/10
1507,962,,Mr. Boat,+1,7,8,47%,15,2023/03/26
1508,962,,rlawodn40,-1,12,12,50%,24,2023/04/14
1509,961,,Tarquin,-2,17,20,46%,37,2023/04/12
1510,961,,Yosugami,+3,64,73,47%,137,2023/04/16
1511,960,,Didier617,+1,14,16,47%,30,2023/04/10
1512,960,,Phteven,+2,11,14,44%,25,2023/03/26
1513,960,,高文爵士,+1,17,23,43%,40,2023/03/21
1514,960,,Death-Bringer,+1,17,16,52%,33,2023/04/18
1515,960,,Gbr95,+1,6,8,43%,14,2023/04/02
1516,960,,Icemann GER,-1,4,7,36%,11,2023/04/15
1517,960,,Bacaphonic,+1,10,12,45%,22,2023/04/12
1518,960,,张越,+1,9,12,43%,21,2023/03/26
1519,959,,Sorry,-5,13,18,42%,31,2023/04/15
1520,959,,Pain_Inside,+3,5,5,50%,10,2023/04/17
1521,959,,Edimax,+2,9,12,43%,21,2023/04/15
1522,959,,Arkman456,-2,4,6,40%,10,2023/04/17
1523,959,,Tamylas,-3,39,38,51%,77,2023/04/17
1524,959,,Ironman_2000,-2,26,26,50%,52,2023/04/07
1525,958,,Raptor,+1,9,13,41%,22,2023/04/14
1526,958,,theawsomguy,-1,7,9,44%,16,2023/03/29
1527,958,,bigchunk1,+2,11,10,52%,21,2023/04/15
1528,958,,Nazi hunter,+2,5,6,45%,11,2023/04/15
1529,958,,unicorn,+1,10,12,45%,22,2023/04/02
1530,957,,Kamikaze-Kurt,-3,6,8,43%,14,2023/03/25
1531,957,,NightLandScape,-1,59,54,52%,113,2023/04/05
1532,957,,Ruvaak,-3,5,8,38%,13,2023/04/07
1533,957,,fabio4516,-3,8,10,44%,18,2023/04/03
1534,957,,IIIIIIIIIIIIIIIII:-P,+2,27,26,51%,53,2023/04/08
1535,957,,Shogun1137,+2,12,12,50%,24,2023/04/02
1536,956,,挖个窟窿过年,+1,12,13,48%,25,2023/03/29
1537,956,,niki,+1,6,8,43%,14,2023/04/17
1538,956,,BRITISH UNION OF BEADY EYES,+1,7,9,44%,16,2023/04/05
1539,956,,MagicPants,-2,6,6,50%,12,2023/04/03
1540,956,,MKP,-1,4,6,40%,10,2023/04/09
1541,956,,Ardent Sentry,+3,12,11,52%,23,2023/04/06
1542,956,,Instinct,+2,6,6,50%,12,2023/03/27
1543,955,,米勒上尉★John millers.us,-1,57,59,49%,116,2023/04/13
1544,955,,Naschfuchs,-3,4,6,40%,10,2023/04/06
1545,955,,Jim Raynor,-1,8,10,44%,18,2023/04/06
1546,955,,ShooterWorld,-1,12,15,44%,27,2023/04/16
1547,955,,TerpeneProfile,-1,10,11,48%,21,2023/04/07
1548,955,,VHSmonster,+1,63,66,49%,129,2023/04/17
1549,955,,Humba,-1,51,53,49%,104,2023/04/02
1550,955,,Nemesis,-3,4,6,40%,10,2023/04/10
1551,954,,MrExec,+4,5,5,50%,10,2023/03/21
1552,954,,ran_to_the_ftl,-3,6,8,43%,14,2023/04/03
1553,954,,Sev,+1,7,7,50%,14,2023/03/30
1554,954,,我干拉了，你呢？,-5,33,30,52%,63,2023/04/17
1555,954,,Nit Rogen,-2,6,7,46%,13,2023/04/11
1556,954,,Zilof,+2,6,8,43%,14,2023/04/04
1557,954,,Fletch,+1,9,11,45%,20,2023/04/16
1558,953,,Subakva_Marmoto (Hysteria),-2,4,6,40%,10,2023/04/13
1559,953,,BSG,-2,11,15,42%,26,2023/04/12
1560,953,,Dini,+2,8,10,44%,18,2023/03/30
1561,953,,***knaeufle***,+1,9,10,47%,19,2023/03/31
1562,952,,成吉思汗,+1,70,73,49%,143,2023/04/02
1563,952,,Iraklius of Kolchis,-1,71,74,49%,145,2023/04/07
1564,952,,Cdbeem,-5,10,14,42%,24,2023/04/17
1565,952,,Doggy,-4,27,32,46%,59,2023/04/09
1566,952,,"Useless, Laggy Player",+1,5,7,42%,12,2023/04/16
1567,952,,ArcticFox,-4,11,14,44%,25,2023/04/17
1568,952,,Myrn,+2,13,17,43%,30,2023/04/15
1569,951,,Surancha,+1,15,14,52%,29,2023/03/25
1570,951,,Comandante[BLR],-2,10,11,48%,21,2023/04/15
1571,951,,熊先森,-2,7,8,47%,15,2023/03/24
1572,951,,Spatzpoleon,-1,5,8,38%,13,2023/03/28
1573,951,,mindarli,+1,19,24,44%,43,2023/04/02
1574,951,,EudardMcGlashan,-1,5,7,42%,12,2023/04/03
1575,950,,Jetzt,+1,4,6,40%,10,2023/04/16
1576,950,,Kanin,-2,7,8,47%,15,2023/04/18
1577,950,,Milan,+1,5,6,45%,11,2023/04/07
1578,950,,Mason,-1,4,7,36%,11,2023/04/16
1579,949,,Pustynny junak,+1,7,9,44%,16,2023/04/17
1580,949,,Caillou,+4,8,7,53%,15,2023/04/09
1581,949,,Reife Stute 43,-1,14,13,52%,27,2023/04/16
1582,949,,aweatherbee0131,+1,11,15,42%,26,2023/04/10
1583,948,,LiveToWin,-2,50,51,50%,101,2023/03/30
1584,948,,Generalxl,-2,5,6,45%,11,2023/03/30
1585,948,,Indiana Jones,+1,26,25,51%,51,2023/04/18
1586,948,,Karol G,+2,9,9,50%,18,2023/04/14
1587,948,,Strikeforce,-1,9,15,38%,24,2023/04/05
1588,948,,luca magno,+1,5,7,42%,12,2023/03/21
1589,947,,MIA_lu,-1,6,6,50%,12,2023/04/07
1590,947,,Dudek Kvar,+1,12,17,41%,29,2023/03/24
1591,947,,Mr. Easy,-4,7,11,39%,18,2023/03/28
1592,947,,Отец Егор,-1,8,13,38%,21,2023/03/31
1593,946,,HamsterofDoom,+2,6,8,43%,14,2023/04/01
1594,946,,ErRo,-2,5,6,45%,11,2023/04/16
1595,946,,Ultron,+1,4,7,36%,11,2023/04/17
1596,946,,testing,-1,5,5,50%,10,2023/03/24
1597,946,,Josef Ballin',-2,10,12,45%,22,2023/03/29
1598,946,,lucasniy,+1,6,9,40%,15,2023/04/12
1599,946,,501.es | OddBall,-1,4,6,40%,10,2023/04/01
1600,946,,SGT Swifter008,-2,9,15,38%,24,2023/04/01
1601,946,,InnessPowers,-1,8,10,44%,18,2023/04/17
1602,946,,AustrianBastard,-1,17,20,46%,37,2023/04/08
1603,946,,咯咯,+3,13,14,48%,27,2023/04/15
1604,945,,MexinTexan,+2,10,10,50%,20,2023/04/09
1605,945,,Major Gladouze,-3,22,24,48%,46,2023/04/05
1606,945,,DigItUp,+2,5,7,42%,12,2023/04/14
1607,945,,marshalrommelfox,+3,36,35,51%,71,2023/04/04
1608,944,,Snoopy,-3,26,42,38%,68,2023/04/13
1609,944,,Krisdt,-3,9,12,43%,21,2023/04/09
1610,944,,BLADE0402,-2,5,7,42%,12,2023/04/08
1611,944,,Delta_Tiger94,-1,14,13,52%,27,2023/04/16
1612,944,,wong.wilfred,+2,31,35,47%,66,2023/04/17
1613,944,,Divine Fury,-1,5,6,45%,11,2023/04/09
1614,943,,fontinixxl,+3,24,27,47%,51,2023/04/17
1615,943,,Opressor,+3,20,20,50%,40,2023/04/12
1616,943,,Teelicht,-8,4,8,33%,12,2023/04/04
1617,943,,BATPIMP,+4,11,11,50%,22,2023/04/13
1618,943,,[FC]XniL,-3,5,7,42%,12,2023/03/27
1619,943,,ming,-1,9,13,41%,22,2023/03/25
1620,942,,Mr.Kuk,-2,4,9,31%,13,2023/04/13
1621,942,,Exodiac,-5,12,15,44%,27,2023/04/06
1622,942,,SaulCaliber,+2,10,12,45%,22,2023/04/16
1623,942,,xuliang16879,+2,8,13,38%,21,2023/03/24
1624,941,,Gaspard,+4,83,78,52%,161,2023/04/08
1625,941,,Drag0nRiderz,-1,28,32,47%,60,2023/04/14
1626,941,,Draco,+1,13,14,48%,27,2023/03/28
1627,941,,alejose303,+2,16,18,47%,34,2023/04/17
1628,941,,leon-van-eijk,-4,7,9,44%,16,2023/03/30
1629,941,,304532544,-1,34,37,48%,71,2023/04/09
1630,940,,Duendex,+1,51,57,47%,108,2023/04/17
1631,940,,SlapInferno,-1,8,9,47%,17,2023/04/09
1632,940,,GaePie,+2,17,19,47%,36,2023/04/16
1633,940,,Tito Fatalez,-2,14,22,39%,36,2023/04/17
1634,940,,JUS7ICE,-1,32,36,47%,68,2023/04/18
1635,940,,Wüstenfuchs,+1,15,18,45%,33,2023/04/03
1636,940,,DrymM8,-6,16,17,48%,33,2023/04/11
1637,939,,connor18,+3,12,11,52%,23,2023/03/31
1638,939,,Gambo,+1,16,17,48%,33,2023/04/11
1639,939,,Gotthirsch,-5,4,6,40%,10,2023/03/29
1640,939,,Phoenix0928,+1,19,22,46%,41,2023/03/27
1641,939,,Panzer-Michl,+1,16,20,44%,36,2023/04/17
1642,939,,notorischer Ver(s)precher,-1,6,7,46%,13,2023/04/15
1643,938,,Bint,+1,40,43,48%,83,2023/04/17
1644,938,,BlacKobs,+3,13,15,46%,28,2023/04/17
1645,938,,Taterbait,-2,21,18,54%,39,2023/04/01
1646,938,,Sebrio,+1,18,20,47%,38,2023/04/07
1647,937,,Kotypa,+1,5,8,38%,13,2023/03/29
1648,937,,神光,+3,23,22,51%,45,2023/04/09
1649,937,,de_prodigz,-1,21,27,44%,48,2023/04/13
1650,937,,Comrade Michael with mask,-1,25,25,50%,50,2023/03/24
1651,937,,Tornholio,+3,14,16,47%,30,2023/04/17
1652,937,,Matthias der Berserker,+3,10,11,48%,21,2023/03/21
1653,937,,Schwerpunkt,+1,6,10,38%,16,2023/03/22
1654,937,,jpcowgill,+4,16,16,50%,32,2023/03/31
1655,936,,Cuban Pete,+1,13,16,45%,29,2023/04/16
1656,936,,Franksalot,-2,10,14,42%,24,2023/04/04
1657,936,,derGenji,+3,24,27,47%,51,2023/04/17
1658,936,,SovietUnionMOGU,-3,9,12,43%,21,2023/04/07
1659,936,,Rockem,-2,17,23,43%,40,2023/04/02
1660,936,,lindsay,+1,10,14,42%,24,2023/03/21
1661,936,,Radu S.a.v.,-1,17,18,49%,35,2023/04/17
1662,935,,[BS™] Krivi,-1,11,12,48%,23,2023/04/02
1663,935,,Petrov,-2,7,11,39%,18,2023/04/08
1664,935,,Akay,-2,20,22,48%,42,2023/03/26
1665,934,,ionkiller,-1,17,19,47%,36,2023/04/17
1666,934,,Pragma,+1,4,6,40%,10,2023/04/01
1667,934,,dogerber,-3,5,7,42%,12,2023/04/02
1668,934,,Huntsman,-5,26,29,47%,55,2023/04/17
1669,934,,Twitch.tv/DirtyKar1,+2,29,34,46%,63,2023/03/30
1670,934,,Spartacus,-1,36,36,50%,72,2023/04/03
1671,933,,St. Bucko Slays the Dragon,-1,17,20,46%,37,2023/04/17
1672,932,,ReliantX,+4,5,5,50%,10,2023/04/01
1673,932,,realkilo,-5,4,6,40%,10,2023/04/09
1674,932,,Ic3DreaM,-1,5,7,42%,12,2023/03/24
1675,932,,bulot,-2,23,27,46%,50,2023/04/15
1676,932,,jlywar,+1,26,28,48%,54,2023/04/14
1677,932,,Maxi,-1,5,8,38%,13,2023/04/10
1678,932,,chiavinatorù,-1,5,8,38%,13,2023/03/28
1679,931,,Admiral Piett,-2,46,50,48%,96,2023/04/17
1680,931,,Cringe Cringle,-7,6,12,33%,18,2023/03/26
1681,931,,Rex Everything,-3,5,8,38%,13,2023/04/11
1682,931,,Midti,+2,15,19,44%,34,2023/04/07
1683,931,,SS20132013,+2,12,19,39%,31,2023/04/09
1684,930,,alcafurbank,+1,119,127,48%,246,2023/04/18
1685,930,,yuanhan.lee,+1,8,9,47%,17,2023/03/30
1686,930,,Ferreyd,+4,7,8,47%,15,2023/04/11
1687,930,,HansGutAryan,+1,4,6,40%,10,2023/03/30
1688,930,,csiga,-2,7,8,47%,15,2023/04/03
1689,929,,Balzdeep,-4,26,29,47%,55,2023/04/02
1690,929,,Brink,-1,5,7,42%,12,2023/04/14
1691,928,,Mentat,-1,6,8,43%,14,2023/04/05
1692,928,,tewnclub,-2,10,12,45%,22,2023/04/14
1693,928,,theo_dream,+1,13,14,48%,27,2023/04/17
1694,928,,Brock,-2,4,7,36%,11,2023/04/15
1695,928,,nonaino,-2,14,18,44%,32,2023/04/16
1696,928,,que,-2,14,19,42%,33,2023/04/16
1697,927,,le Régent,+1,7,10,41%,17,2023/04/17
1698,927,,Dream Mariner,+3,11,11,50%,22,2023/04/17
1699,927,,PURE_FROG,-2,16,24,40%,40,2023/04/13
1700,927,,tobias.1302,+1,11,18,38%,29,2023/04/15
1701,927,,wheeletan,-2,5,8,38%,13,2023/04/16
1702,927,,MikeyxD,-1,12,18,40%,30,2023/03/26
1703,927,,Not Tommy,+2,4,6,40%,10,2023/03/30
1704,925,,[HAN]黯舞者黑刀,+1,15,21,42%,36,2023/04/02
1705,925,,Imperator Thrax,-1,28,34,45%,62,2023/04/17
1706,925,,Von Seltei,+1,23,23,50%,46,2023/04/18
1707,925,,霍子,+2,15,21,42%,36,2023/04/16
1708,924,,Leonatus,-2,28,31,47%,59,2023/04/17
1709,924,,Baessler,-1,9,12,43%,21,2023/04/17
1710,924,,Mortar Punch,-2,5,8,38%,13,2023/04/05
1711,924,,Nogea,+2,12,12,50%,24,2023/03/28
1712,924,,DomInic,-3,17,25,40%,42,2023/03/27
1713,924,,godjaeseng1,-2,6,7,46%,13,2023/03/25
1714,923,,DragonFaith,+1,13,18,42%,31,2023/04/17
1715,923,,cancerrob,-2,7,9,44%,16,2023/04/07
1716,922,,pycholon,-2,15,19,44%,34,2023/04/15
1717,922,,Waldgeister,-2,4,6,40%,10,2023/04/15
1718,922,,William9796,+2,10,15,40%,25,2023/04/06
1719,921,,YYY_近战法师刘海柱,-1,19,21,48%,40,2023/03/29
1720,921,,Snackbar Chez Raymond,+3,9,11,45%,20,2023/03/26
1721,921,,MR CAT,+1,5,8,38%,13,2023/04/08
1722,921,,BooknightZ,-2,3,7,30%,10,2023/03/31
1723,921,,Deathmatch,-5,5,9,36%,14,2023/03/21
1724,921,,xOutpost,+1,6,8,43%,14,2023/04/03
1725,921,,supercxt,-7,2,8,20%,10,2023/04/11
1726,921,,fran,-1,24,31,44%,55,2023/04/12
1727,920,,Viva La Bunny,-1,4,6,40%,10,2023/04/02
1728,920,,CZECH /1st. Division,+1,8,12,40%,20,2023/04/01
1729,920,,MatZpt,+1,6,9,40%,15,2023/04/16
1730,920,,Kirov Reporting,-2,7,9,44%,16,2023/04/17
1731,919,,Disi,-2,6,10,38%,16,2023/04/02
1732,919,,Wunderwaffe,+1,9,13,41%,22,2023/04/01
1733,919,,STONEgolem,-2,5,8,38%,13,2023/03/29
1734,919,,AssInspection,+2,17,16,52%,33,2023/04/03
1735,919,,Komioski,-5,4,7,36%,11,2023/03/25
1736,918,,Killer100,+1,4,7,36%,11,2023/04/13
1737,918,,L. Vorenus,+1,16,20,44%,36,2023/04/15
1738,918,,MEDDLE+FEEN,-1,16,23,41%,39,2023/04/04
1739,918,,Kernbohrer2000,-2,8,9,47%,17,2023/04/15
1740,918,,ibraheem0Alpha,-2,25,25,50%,50,2023/04/09
1741,918,,Eddgar Stark,+1,3,7,30%,10,2023/04/14
1742,918,,Че,-2,13,14,48%,27,2023/03/30
1743,918,,Jørund,-2,8,10,44%,18,2023/04/16
1744,917,,gamerguy298,-1,3,7,30%,10,2023/03/28
1745,917,,AlexanderTGreat,-5,71,71,50%,142,2023/04/17
1746,917,,OneX,-1,7,10,41%,17,2023/03/31
1747,917,,BarrackOBombya,-1,8,11,42%,19,2023/04/11
1748,917,,sunny_yeung,+1,15,17,47%,32,2023/04/07
1749,917,,Armstroan Bance,-1,5,7,42%,12,2023/04/05
1750,916,,UneXplain,-2,37,41,47%,78,2023/04/04
1751,916,,Xampoo - có3 é bõ,-1,12,15,44%,27,2023/04/11
1752,916,,MagicBlue,+1,16,22,42%,38,2023/03/27
1753,916,,scheme,+1,27,28,49%,55,2023/04/13
1754,916,,秦＃NAME?,-3,4,6,40%,10,2023/04/16
1755,915,,vctorgab,+2,17,17,50%,34,2023/04/10
1756,915,,Eric,-3,6,9,40%,15,2023/04/09
1757,915,,Nefretus,-2,40,33,55%,73,2023/04/12
1758,915,,LEOMNERY,+2,4,8,33%,12,2023/04/09
1759,915,,Wicerawen,-1,3,7,30%,10,2023/04/10
1760,914,,Mazi,+2,13,13,50%,26,2023/04/16
1761,914,,NorrisCertified,-1,4,6,40%,10,2023/03/30
1762,914,,matsieron,-5,22,29,43%,51,2023/04/12
1763,914,,[P-CAN] ttv/cccilytf2,+1,10,16,38%,26,2023/04/13
1764,914,,Lowkey,+1,4,7,36%,11,2023/04/04
1765,914,,莣孓嗳,-1,11,13,46%,24,2023/04/09
1766,913,,AC04,-1,7,8,47%,15,2023/03/21
1767,913,,571803985,-1,7,10,41%,17,2023/04/09
1768,913,,von FEVS,-8,20,28,42%,48,2023/04/11
1769,913,,GinoLui92,-7,14,22,39%,36,2023/04/11
1770,913,,Katanalia.TH,-1,7,10,41%,17,2023/03/26
1771,913,,LEOPARD1492,+3,19,27,41%,46,2023/04/17
1772,912,,No this is patrick,-1,5,7,42%,12,2023/04/03
1773,912,,TortoiseGods,-3,20,22,48%,42,2023/03/23
1774,912,,1900,+1,11,18,38%,29,2023/04/14
1775,912,,alberugi00,+4,20,20,50%,40,2023/04/05
1776,912,,wespelarno,+2,10,16,38%,26,2023/04/16
1777,911,,0RCcA,-3,6,9,40%,15,2023/03/22
1778,911,,Handsome Jack,-4,5,9,36%,14,2023/04/01
1779,911,,Seismic Squall,-3,20,25,44%,45,2023/04/17
1780,911,,Trifulcas,+2,20,23,47%,43,2023/03/29
1781,911,,JetPlane,-1,7,12,37%,19,2023/04/16
1782,911,,Rangersace,-1,5,7,42%,12,2023/04/15
1783,911,,ohlsson,+3,6,7,46%,13,2023/04/14
1784,910,,azur,-1,15,19,44%,34,2023/04/16
1785,910,,疯狂梅西,-3,25,34,42%,59,2023/04/16
1786,909,,Columbus,-1,6,10,38%,16,2023/04/08
1787,909,,62frn,+3,19,21,48%,40,2023/04/17
1788,909,,Yeknod,-1,11,15,42%,26,2023/04/16
1789,908,,pleighto,-1,10,16,38%,26,2023/04/08
1790,908,,Phobiaꟼ,-3,5,9,36%,14,2023/04/16
1791,908,,Mister A.K.,-2,10,20,33%,30,2023/03/28
1792,908,,Para,+1,6,9,40%,15,2023/04/02
1793,908,,116276339,-4,14,21,40%,35,2023/04/05
1794,907,,GröFaZ,-3,24,33,42%,57,2023/04/16
1795,907,,Sacro,+3,5,8,38%,13,2023/04/01
1796,907,,Dimairt,+1,12,11,52%,23,2023/04/18
1797,907,,TheMandoX2,-2,29,34,46%,63,2023/04/03
1798,906,,Alitheion,-2,8,11,42%,19,2023/04/16
1799,906,,Big Ham,+1,12,17,41%,29,2023/04/09
1800,906,,Wtx.Ranger17,+1,4,6,40%,10,2023/04/16
1801,906,,nicoleabeller,-3,4,9,31%,13,2023/04/16
1802,906,,kiwisteel_95,-1,46,53,46%,99,2023/04/09
1803,906,,hallolinski,-2,4,7,36%,11,2023/04/17
1804,905,,DRDOOM_NZ,-3,19,23,45%,42,2023/04/03
1805,905,,Polarbear847,-2,6,8,43%,14,2023/03/22
1806,905,,Zaziggi,-3,6,10,38%,16,2023/04/02
1807,905,,ezpz|Gyron,+3,6,8,43%,14,2023/03/25
1808,905,,Stannis the Mannis,-3,4,7,36%,11,2023/03/26
1809,905,,Sadox,-1,12,16,43%,28,2023/04/14
1810,905,,Skaarup,-6,4,7,36%,11,2023/04/13
1811,905,,Steiner85,+4,11,10,52%,21,2023/04/14
1812,905,,BestyBallz,-2,39,46,46%,85,2023/04/17
1813,904,,NaughtyTeddy69,-1,5,9,36%,14,2023/04/13
1814,904,,vipasyn,-1,4,7,36%,11,2023/03/28
1815,904,,Wazda Deelwifkramer,-4,4,9,31%,13,2023/04/09
1816,903,,Hulkster,-2,18,18,50%,36,2023/04/15
1817,903,,leroy,+1,18,22,45%,40,2023/04/11
1818,903,,El Stosso,+2,4,6,40%,10,2023/04/01
1819,903,,ragemodeactivate,+2,4,6,40%,10,2023/04/16
1820,903,,King CCM,-3,10,16,38%,26,2023/04/05
1821,903,,DerBubu,-1,9,13,41%,22,2023/04/14
1822,903,,Ghandalf (NL),+3,4,7,36%,11,2023/04/17
1823,902,,jmilli10,-2,5,7,42%,12,2023/04/02
1824,901,,LiarFox,-4,34,44,44%,78,2023/04/08
1825,901,,D.LiuMimm,+1,12,18,40%,30,2023/04/16
1826,899,,FriedRavioli,+1,6,10,38%,16,2023/04/11
1827,899,,GearStrife,-3,4,7,36%,11,2023/04/02
1828,899,,Hans von Glocken,-1,7,13,35%,20,2023/04/15
1829,899,,kiler47,-3,33,37,47%,70,2023/04/15
1830,899,,DiscoFork88,-3,6,10,38%,16,2023/03/23
1831,899,,DeathBringeR,-1,9,16,36%,25,2023/04/17
1832,899,,FuddTator,-3,6,9,40%,15,2023/03/29
1833,899,,Playgrandmin,+3,6,8,43%,14,2023/04/12
1834,899,,TakePTOandPlayCoh3,-2,54,62,47%,116,2023/04/16
1835,898,,Diccolo,-1,17,23,43%,40,2023/04/17
1836,898,,nass1,-1,9,13,41%,22,2023/04/16
1837,898,,be4rd3d_s4murai,-1,18,19,49%,37,2023/03/23
1838,898,,mav_powder,-5,5,9,36%,14,2023/04/16
1839,897,,yhuang,+2,4,6,40%,10,2023/03/31
1840,897,,Mick,-3,15,21,42%,36,2023/04/17
1841,896,,Rü Guerrero,-1,16,17,48%,33,2023/04/03
1842,896,,Endless,-1,12,15,44%,27,2023/03/22
1843,896,,GizmoTR,+1,4,6,40%,10,2023/04/16
1844,896,,Janos,-5,4,8,33%,12,2023/03/31
1845,895,,Azang0,-2,4,6,40%,10,2023/03/22
1846,895,,Azrael,-2,27,26,51%,53,2023/04/02
1847,895,,HostileCamper,+1,28,31,47%,59,2023/04/16
1848,894,,Chronos,-2,6,8,43%,14,2023/04/15
1849,894,,suchar_86,-4,4,6,40%,10,2023/04/17
1850,894,,kev1287,+2,10,11,48%,21,2023/04/17
1851,894,,noprisonersnick,-1,8,11,42%,19,2023/04/03
1852,893,,-SIBERIANWOLF-,-1,10,12,45%,22,2023/04/18
1853,892,,xSAMINALx,-1,6,11,35%,17,2023/04/18
1854,891,,Ostinato,-3,12,14,46%,26,2023/03/30
1855,891,,Nealsen,-2,18,21,46%,39,2023/04/10
1856,891,,Phönix SL,-1,5,8,38%,13,2023/04/14
1857,891,,RoGueDanneRZ,-3,51,65,44%,116,2023/04/09
1858,891,,li5235577,-1,10,15,40%,25,2023/03/22
1859,890,,[GDAS] Enrico12222,-2,14,19,42%,33,2023/04/07
1860,890,,IronMan,+1,42,45,48%,87,2023/04/16
1861,890,,Fidel Cashflow,-3,8,12,40%,20,2023/04/11
1862,890,,HappySturmtiger,+1,4,7,36%,11,2023/04/02
1863,889,,ioio,-2,39,45,46%,84,2023/04/18
1864,889,,Redcable,+4,39,52,43%,91,2023/04/16
1865,888,,[BDSQ] DeadlyColombian,-3,17,24,41%,41,2023/04/13
1866,888,,mool,+1,12,18,40%,30,2023/04/02
1867,888,,Major R. Sole,+1,15,20,43%,35,2023/04/17
1868,888,,Breezey,-2,3,7,30%,10,2023/04/17
1869,888,,Mephswall,+1,9,14,39%,23,2023/04/08
1870,888,,shinjp,-1,12,16,43%,28,2023/04/05
1871,887,,mthrowaway,-2,14,19,42%,33,2023/04/07
1872,887,,应急食品派蒙,-1,74,90,45%,164,2023/04/12
1873,886,,bassius,+1,55,61,47%,116,2023/04/06
1874,886,,abs0843,+1,5,10,33%,15,2023/04/09
1875,885,,elbastardo77,-7,8,16,33%,24,2023/04/15
1876,885,,he565,-1,27,32,46%,59,2023/04/16
1877,885,,KlerosTNT,-2,16,24,40%,40,2023/03/24
1878,885,,rasta_poux,+2,15,18,45%,33,2023/04/09
1879,884,,Zipotonez,-3,11,13,46%,24,2023/03/23
1880,884,,ajpriv,-2,4,8,33%,12,2023/04/17
1881,883,,Bloodraven,-1,16,22,42%,38,2023/04/09
1882,883,,快看有巨雕,-1,8,9,47%,17,2023/04/17
1883,883,,Struppe,-5,12,18,40%,30,2023/04/03
1884,882,,Tankstellenfasan,+2,7,13,35%,20,2023/03/26
1885,882,,SoLucian,-2,6,10,38%,16,2023/04/14
1886,882,,'Keeperandersen^¨,+1,4,7,36%,11,2023/04/08
1887,882,,Stark,+3,8,12,40%,20,2023/04/08
1888,882,,Vapes 4 Christ,+1,9,13,41%,22,2023/03/29
1889,882,,danny7887,-7,4,11,27%,15,2023/04/14
1890,881,,OIDA,-1,50,59,46%,109,2023/04/17
1891,881,,crackyy,+5,15,16,48%,31,2023/04/14
1892,881,,God Emperor,-5,10,17,37%,27,2023/04/18
1893,880,,Boogaloo,+2,22,27,45%,49,2023/04/16
1894,880,,SetanGer59,+1,4,7,36%,11,2023/04/03
1895,879,,Saitenspiel,-1,14,21,40%,35,2023/04/08
1896,879,,=UwG=Sharpshot007,-1,61,59,51%,120,2023/04/08
1897,879,,errrh,+1,13,17,43%,30,2023/04/12
1898,878,,SteezyFebrezeMe,+1,6,9,40%,15,2023/04/04
1899,878,,Sc@rf@ce,-5,5,8,38%,13,2023/04/08
1900,878,,profweetard,+1,9,13,41%,22,2023/03/28
1901,878,,Cherokee,-2,23,24,49%,47,2023/04/02
1902,877,,Big Yellow,-1,5,9,36%,14,2023/04/13
1903,877,,HeavyD,+2,16,20,44%,36,2023/04/04
1904,877,,kinaistarwars,+1,5,9,36%,14,2023/04/04
1905,876,,Auld Smokey,-2,5,9,36%,14,2023/04/05
1906,876,,oca selvatica,+2,15,23,39%,38,2023/04/17
1907,875,,Canine,-2,24,29,45%,53,2023/04/01
1908,875,,michael_airforce,-2,28,36,44%,64,2023/03/25
1909,875,,nesqu,-1,6,8,43%,14,2023/03/30
1910,874,,Spritzgebäck,-1,19,24,44%,43,2023/04/10
1911,874,,蜻蜓队长,+1,5,9,36%,14,2023/04/11
1912,873,,ottomanslap,-5,18,21,46%,39,2023/03/24
1913,873,,Tom Honk,+2,15,16,48%,31,2023/04/16
1914,873,,Der Tod,-2,8,12,40%,20,2023/03/30
1915,873,,Alwaroski,-5,5,10,33%,15,2023/04/15
1916,873,,janko,-6,3,8,27%,11,2023/04/13
1917,873,,AlanKWY,+3,5,8,38%,13,2023/04/13
1918,872,,Mysticassbreaker,+1,20,23,47%,43,2023/04/03
1919,872,,benJ_DE,-2,12,20,38%,32,2023/04/01
1920,872,,Ciaphas Cain,-7,3,7,30%,10,2023/03/22
1921,872,,Night,-4,4,7,36%,11,2023/04/15
1922,871,,Relaxaurus,-2,6,10,38%,16,2023/04/16
1923,871,,TwiddleCZ,+1,27,33,45%,60,2023/04/17
1924,870,,Unteuchible,+2,8,12,40%,20,2023/04/04
1925,869,,sky,-11,3,12,20%,15,2023/04/04
1926,869,,OFw.Meyer,+1,15,17,47%,32,2023/04/13
1927,867,,Rodeo knight,-3,5,8,38%,13,2023/03/21
1928,867,,Mr.Luger,-1,6,10,38%,16,2023/03/27
1929,867,,DarthYukat,-3,3,7,30%,10,2023/03/31
1930,866,,Astartes,+2,4,7,36%,11,2023/04/07
1931,865,,murlocmarine,-1,6,11,35%,17,2023/04/12
1932,865,,jambomir,-3,7,11,39%,18,2023/04/15
1933,865,,Deamon Core,-2,5,9,36%,14,2023/04/14
1934,864,,KleinMeser,-1,15,21,42%,36,2023/04/09
1935,864,,artemhs1821,-1,22,27,45%,49,2023/04/17
1936,863,,jamessilva12,-5,7,13,35%,20,2023/04/14
1937,863,,Mr.Alex97,+2,8,13,38%,21,2023/03/29
1938,863,,Claymorefun,-4,5,9,36%,14,2023/04/14
1939,862,,Cal Clutterbuck,-3,5,10,33%,15,2023/04/03
1940,862,,Enriquexs(CHI),+3,8,13,38%,21,2023/04/17
1941,860,,MtCassino,+2,15,18,45%,33,2023/04/18
1942,860,,dotvz,-1,15,28,35%,43,2023/04/13
1943,860,,wckgg_87429656,-1,22,27,45%,49,2023/04/08
1944,859,,dutchdisaster,-1,6,8,43%,14,2023/04/16
1945,859,,provence52bouquet,-3,4,9,31%,13,2023/03/31
1946,859,,Tschanis,-1,30,40,43%,70,2023/04/14
1947,859,,Friss,-1,6,10,38%,16,2023/03/31
1948,856,,Pvt Porker,-1,9,14,39%,23,2023/04/15
1949,856,,FiziksXT,-2,6,9,40%,15,2023/04/13
1950,856,,CorruptCornflake,-2,4,12,25%,16,2023/04/16
1951,856,,Shion,-5,4,10,29%,14,2023/04/17
1952,855,,NEILO-LTC,-1,18,18,50%,36,2023/03/25
1953,855,,伊庭,-5,3,7,30%,10,2023/04/02
1954,855,,lane.hawkins.89,+2,8,11,42%,19,2023/03/28
1955,855,,ForwardUntilDawn,-2,6,9,40%,15,2023/03/24
1956,854,,JPJ,-1,7,9,44%,16,2023/04/08
1957,853,,Mikkelrev,-2,60,67,47%,127,2023/03/21
1958,853,,Buck Spaceman,+1,16,22,42%,38,2023/04/14
1959,852,,OMGISJJ,-3,5,7,42%,12,2023/04/12
1960,852,,Manga,+2,12,16,43%,28,2023/04/14
1961,852,,juan-pablo-rc,+2,8,11,42%,19,2023/04/12
1962,852,,Dr. Malma,+1,2,8,20%,10,2023/03/23
1963,852,,z72124223,+1,64,67,49%,131,2023/03/22
1964,851,,Prof. Fart's Sniff Emporium,-1,5,10,33%,15,2023/03/21
1965,851,,Bonpoint,-3,4,7,36%,11,2023/04/06
1966,850,,Tomar80,-3,3,7,30%,10,2023/04/16
1967,850,,EsaRys,-1,43,48,47%,91,2023/03/30
1968,848,,ACE,+1,4,8,33%,12,2023/04/01
1969,848,,freeman248xz,-2,50,64,44%,114,2023/04/17
1970,848,,wojak zoomer,+1,5,9,36%,14,2023/04/14
1971,848,,Canete,+2,16,19,46%,35,2023/04/05
1972,848,,alphazaheer,+2,4,7,36%,11,2023/04/18
1973,847,,__++__==,+1,79,95,45%,174,2023/04/10
1974,846,,Volksgrenadier,+1,9,11,45%,20,2023/04/15
1975,846,,아냐쎄여,-1,3,7,30%,10,2023/03/24
1976,846,,Apemanx,-1,3,8,27%,11,2023/03/21
1977,846,,väderstad,-4,3,8,27%,11,2023/04/17
1978,845,,donkeypunter,+1,41,57,42%,98,2023/04/17
1979,845,,溺水的巨人,-6,19,30,39%,49,2023/04/08
1980,844,,Freki__98,-3,10,15,40%,25,2023/04/10
1981,844,,morris,+1,13,19,41%,32,2023/03/27
1982,844,,KUBLAI KHAN,-4,6,11,35%,17,2023/04/01
1983,844,,jarlzandvoort123,-3,2,8,20%,10,2023/04/11
1984,844,,mcmiff1,-1,3,7,30%,10,2023/04/16
1985,843,,diango40,-1,7,12,37%,19,2023/03/31
1986,843,,Rayduhz,+1,10,23,30%,33,2023/04/09
1987,843,,ESC,-1,4,8,33%,12,2023/04/01
1988,842,,a7695834,-8,4,11,27%,15,2023/04/16
1989,842,,Thala / Chris,+1,7,15,32%,22,2023/03/29
1990,840,,SunBro,+1,11,17,39%,28,2023/04/02
1991,839,,marijuana,+1,8,14,36%,22,2023/04/12
1992,838,,División Azul,+1,17,23,43%,40,2023/04/17
1993,838,,donkih0t,-3,14,20,41%,34,2023/03/28
1994,838,,Panzer,+1,7,12,37%,19,2023/03/30
1995,838,,Kasparov,-5,3,8,27%,11,2023/03/30
1996,838,,Wodan,+1,3,8,27%,11,2023/04/08
1997,837,,ZioAlec,-1,6,10,38%,16,2023/04/11
1998,837,,Нагибатор228,-3,9,15,38%,24,2023/03/26
1999,837,,Maciuś i Tatuś,+3,7,12,37%,19,2023/04/10
2000,836,,OniZimma,-2,16,20,44%,36,2023/03/28
2001,836,,Stuka_Ju87,+1,15,22,41%,37,2023/04/15
2002,834,,jeffseasons,-1,4,8,33%,12,2023/04/05
2003,833,,DabHabbits,+1,5,10,33%,15,2023/04/16
2004,833,,Logan,+3,6,10,38%,16,2023/04/03
2005,833,,dam8909,+4,7,11,39%,18,2023/04/08
2006,833,,bOipuSsi AiNt gAE,+1,42,54,44%,96,2023/04/04
2007,831,,\/\/,-1,11,18,38%,29,2023/04/17
2008,831,,Juniorpred,-2,2,8,20%,10,2023/04/12
2009,831,,2501885777,-1,17,23,43%,40,2023/04/17
2010,831,,Death_dnb,+1,31,36,46%,67,2023/04/15
2011,831,,twa9238,-2,6,11,35%,17,2023/04/13
2012,830,,Vampir,-3,11,17,39%,28,2023/04/10
2013,830,,Schmedium Toaster,-2,11,18,38%,29,2023/04/03
2014,829,,Bino,+2,7,13,35%,20,2023/04/17
2015,829,,Kusty,-2,4,8,33%,12,2023/03/23
2016,828,,`Sury.,-2,6,11,35%,17,2023/04/01
2017,828,,FrostNuke,-3,3,7,30%,10,2023/04/08
2018,828,,川哥指哪我打哪,+1,10,17,37%,27,2023/03/30
2019,827,,Blacksmith,+1,9,16,36%,25,2023/04/18
2020,827,,sdgreene,-1,15,28,35%,43,2023/04/14
2021,826,,24,-1,9,14,39%,23,2023/04/17
2022,825,,cruelaflood,-3,8,15,35%,23,2023/04/15
2023,825,,doctorpanzer,+1,100,130,43%,230,2023/04/17
2024,825,,water,-5,8,18,31%,26,2023/04/11
2025,824,,MZ599,-6,3,11,21%,14,2023/03/30
2026,824,,[HAN] BLUE,+1,3,7,30%,10,2023/04/03
2027,824,,spaghetti671,+1,35,41,46%,76,2023/03/30
2028,824,,JustinTheLord,-1,5,11,31%,16,2023/04/17
2029,824,,Khârn,-3,3,8,27%,11,2023/04/05
2030,823,,xXxVV177D3B345TxXx,-3,3,7,30%,10,2023/04/05
2031,823,,Grover the Trash Hermit,-3,11,21,34%,32,2023/04/17
2032,823,,furious chicken,-3,4,11,27%,15,2023/03/29
2033,823,,^24k,-3,19,26,42%,45,2023/03/31
2034,823,,thenelson,-2,20,33,38%,53,2023/04/12
2035,823,,Robzen,+2,5,12,29%,17,2023/03/24
2036,822,,dascowman,-4,4,9,31%,13,2023/04/16
2037,822,,av3ng3rr,-2,41,55,43%,96,2023/04/17
2038,822,,ResKZer,-1,9,16,36%,25,2023/04/15
2039,821,,micro,-1,7,11,39%,18,2023/04/17
2040,821,,Frank&Martha,-3,5,9,36%,14,2023/03/24
2041,821,,Azildrake,+1,3,8,27%,11,2023/04/09
2042,820,,Gluengi,+1,5,11,31%,16,2023/04/09
2043,820,,IncognitoBurrito,+1,4,10,29%,14,2023/04/11
2044,820,,Esox Lucius,-3,15,21,42%,36,2023/04/05
2045,819,,B4Z00K4,+2,3,7,30%,10,2023/03/29
2046,819,,舒潔衛生紙,-4,4,9,31%,13,2023/03/22
2047,819,,Bushmān,-1,3,9,25%,12,2023/03/22
2048,819,,< blank >,+1,5,10,33%,15,2023/04/14
2049,819,,tom Bradley,+1,4,8,33%,12,2023/03/25
2050,819,,JackyChen,+2,10,17,37%,27,2023/04/02
2051,818,,{SCTY} John Valdez,-1,23,36,39%,59,2023/04/18
2052,818,,MrFuManShu,-4,4,9,31%,13,2023/04/09
2053,818,,Ryan,+1,4,9,31%,13,2023/04/17
2054,818,,Schach,-3,4,10,29%,14,2023/04/11
2055,818,,LORDTYRANNO,+5,24,38,39%,62,2023/04/08
2056,817,,SerMack,-1,5,9,36%,14,2023/04/05
2057,816,,borgy95,-3,7,13,35%,20,2023/03/21
2058,816,,Jordy,-2,33,50,40%,83,2023/04/14
2059,814,,Steven Seagal,-5,6,11,35%,17,2023/03/26
2060,813,,iBucNasty,-3,3,9,25%,12,2023/04/17
2061,812,,Sebbest1,-1,19,29,40%,48,2023/04/18
2062,812,,2015044103,-2,2,9,18%,11,2023/04/16
2063,812,,Strauß,+1,19,28,40%,47,2023/04/17
2064,811,,Nelton,+2,17,32,35%,49,2023/04/16
2065,811,,hoiKINpig,-3,5,15,25%,20,2023/04/11
2066,811,,TeufelHund,-2,14,20,41%,34,2023/04/16
2067,810,,MIIIKU39,-1,4,9,31%,13,2023/04/10
2068,810,,Ocelot,+2,22,31,42%,53,2023/04/17
2069,810,,Sir Petecchio,-1,5,11,31%,16,2023/04/18
2070,810,,PirsJ,-5,6,14,30%,20,2023/03/31
2071,809,,RAF FR,-1,8,15,35%,23,2023/04/17
2072,809,,caxulito,-5,3,9,25%,12,2023/03/27
2073,809,,ChoiceCamp,-7,3,9,25%,12,2023/04/03
2074,808,,MaxBenJim,-1,6,12,33%,18,2023/03/27
2075,808,,Siegesmarsch,+4,9,14,39%,23,2023/04/16
2076,808,,Cherubim,-4,6,13,32%,19,2023/03/29
2077,806,,Cahir de Seren,-2,3,8,27%,11,2023/04/05
2078,806,,Yffan,-4,8,18,31%,26,2023/04/13
2079,805,,penis colada,-2,2,8,20%,10,2023/04/17
2080,805,,Gato,-4,3,9,25%,12,2023/03/23
2081,804,,Lasher,-4,20,29,41%,49,2023/03/24
2082,803,,wstreb,+1,6,12,33%,18,2023/04/02
2083,803,,michalhori,-3,4,9,31%,13,2023/04/15
2084,803,,Shafty,-1,10,17,37%,27,2023/03/25
2085,803,,$zczuto,-3,11,16,41%,27,2023/04/14
2086,803,,Brother,-1,12,16,43%,28,2023/03/27
2087,802,,dreamrebel,-1,7,13,35%,20,2023/04/08
2088,801,,Anarchism,+1,13,16,45%,29,2023/04/16
2089,800,,Ocelot,-2,25,29,46%,54,2023/04/17
2090,800,,PREDATOR,+4,13,22,37%,35,2023/04/15
2091,800,,NFK,+1,8,14,36%,22,2023/03/25
2092,800,,Rauchender Gott,-3,3,9,25%,12,2023/04/10
2093,799,,MIDO,-1,5,8,38%,13,2023/03/25
2094,799,,Run Run Run,+1,3,10,23%,13,2023/03/21
2095,798,,菜虫佳宁,-4,2,8,20%,10,2023/03/22
2096,798,,Théophile de Lerne,+3,12,19,39%,31,2023/04/09
2097,798,,不关橙猫猫的事,-1,38,49,44%,87,2023/04/16
2098,797,,M3di4t0r,-5,3,10,23%,13,2023/04/08
2099,795,,Suppomann,-5,7,16,30%,23,2023/04/16
2100,795,,davide_69,+1,4,9,31%,13,2023/04/17
2101,794,,notcoffee,+1,4,13,24%,17,2023/04/12
2102,794,,DonStatus87,-1,20,26,43%,46,2023/04/03
2103,794,,Ezykl,-1,6,13,32%,19,2023/04/13
2104,794,,Thibonx,-5,4,11,27%,15,2023/04/13
2105,794,,多兰之魔法师,+1,1,9,10%,10,2023/03/23
2106,790,,Seeker2007,-1,13,20,39%,33,2023/04/01
2107,790,,Yellen,+2,9,20,31%,29,2023/04/12
2108,789,,Vexmeister,-1,4,10,29%,14,2023/04/06
2109,788,,ULTRAHBUDDAH,-7,2,8,20%,10,2023/03/31
2110,788,,欧神仙,-2,4,11,27%,15,2023/04/12
2111,788,,德瑞克,-2,8,14,36%,22,2023/04/16
2112,787,,sebaschaos,-3,2,8,20%,10,2023/03/25
2113,786,,0903bear850170,-3,3,12,20%,15,2023/04/02
2114,786,,Jinxx,+1,9,17,35%,26,2023/03/30
2115,785,,mschaneman,-1,3,10,23%,13,2023/04/17
2116,785,,bl4ckjack,-1,3,9,25%,12,2023/04/12
2117,784,,PrinceGoro,+1,3,9,25%,12,2023/04/03
2118,783,,JohnCalvin,-11,12,23,34%,35,2023/04/06
2119,782,,Fragm3nt,-3,16,24,40%,40,2023/03/28
2120,782,,piotrr.malicki,+2,52,72,42%,124,2023/04/17
2121,780,,kaczq4,+1,3,11,21%,14,2023/04/10
2122,780,,riruk,-1,8,17,32%,25,2023/04/15
2123,779,,Gandy,-2,4,13,24%,17,2023/04/15
2124,779,,1261944031,-3,18,39,32%,57,2023/03/28
2125,778,,sensualbananas,-8,2,12,14%,14,2023/04/01
2126,776,,PANO,-3,3,9,25%,12,2023/04/16
2127,775,,robisan,-6,15,23,39%,38,2023/04/16
2128,775,,windonet,-1,41,54,43%,95,2023/04/15
2129,775,,megaspoonz,+1,5,13,28%,18,2023/04/16
2130,774,,Tambo,-3,2,10,17%,12,2023/03/23
2131,773,,Rakke1848,+1,6,16,27%,22,2023/04/16
2132,773,,Gerd Von Rundstedt,-7,4,10,29%,14,2023/04/11
2133,773,,930328284,-2,4,9,31%,13,2023/04/10
2134,772,,starboy,-2,102,161,39%,263,2023/04/17
2135,771,,dave66x6,-1,24,39,38%,63,2023/04/15
2136,771,,how to play,+1,8,14,36%,22,2023/03/31
2137,770,,750155467,+1,2,8,20%,10,2023/04/17
2138,770,,Hrungner,-3,5,10,33%,15,2023/04/17
2139,769,,Goregoroth,-4,2,8,20%,10,2023/04/06
2140,768,,Spontaneous,-1,3,10,23%,13,2023/04/13
2141,768,,Ultraprimat,-2,10,24,29%,34,2023/04/13
2142,767,,19barbar86,-2,32,47,41%,79,2023/04/16
2143,767,,whothefock,+2,14,28,33%,42,2023/04/14
2144,765,,[YHG]TLK,-5,3,11,21%,14,2023/03/31
2145,765,,NoobMicro,-4,2,8,20%,10,2023/03/21
2146,765,,AETIUS,+1,3,9,25%,12,2023/04/13
2147,764,,bboymac,-1,4,11,27%,15,2023/03/25
2148,759,,Angeluz Mortiz,-3,7,14,33%,21,2023/03/21
2149,759,,ATROSERIP,+1,4,11,27%,15,2023/04/17
2150,758,,HSken,-2,3,9,25%,12,2023/03/31
2151,758,,rob-BFE,-2,10,21,32%,31,2023/03/26
2152,758,,阿潘,-7,17,30,36%,47,2023/03/22
2153,756,,犀牛丨英雄连3丨bii,+1,4,12,25%,16,2023/04/15
2154,755,,tritri,-3,2,12,14%,14,2023/03/29
2155,755,,Charon,-1,9,16,36%,25,2023/04/11
2156,755,,Killercrab1065,-3,4,11,27%,15,2023/04/13
2157,754,,Nachtgespenst,-7,3,15,17%,18,2023/04/16
2158,754,,LoneRaider,-4,13,25,34%,38,2023/04/07
2159,751,,General Ho Lee phuc,-5,10,25,29%,35,2023/04/12
2160,750,,silent_hero,-5,2,11,15%,13,2023/04/08
2161,749,,Aurelianus,-1,11,31,26%,42,2023/04/12
2162,748,,Cthulhu,-5,30,46,39%,76,2023/04/15
2163,746,,Nrgy,-5,1,9,10%,10,2023/04/17
2164,745,,polaroi,+1,1,9,10%,10,2023/04/10
2165,744,,GooDyBalL,-5,2,10,17%,12,2023/04/09
2166,741,,binari,-2,17,31,35%,48,2023/04/03
2167,737,,mar14n,+2,11,26,30%,37,2023/04/17
2168,734,,Koiote,+1,3,10,23%,13,2023/04/17
2169,734,,Bradbury,+1,3,11,21%,14,2023/03/27
2170,733,,vomi sanguin 69,-6,3,11,21%,14,2023/03/22
2171,728,,yboy623,-3,5,14,26%,19,2023/03/29
2172,728,,funkybeer,-5,15,34,31%,49,2023/04/03
2173,725,,퓨리[korea],-8,2,9,18%,11,2023/04/17
2174,724,,moon,-7,58,100,37%,158,2023/04/17
2175,722,,krusty,-3,2,9,18%,11,2023/03/24
2176,719,,3che,+2,6,16,27%,22,2023/03/27
2177,719,,無常,+1,5,18,22%,23,2023/04/08
2178,716,,Hasthur,-3,9,17,35%,26,2023/04/17
2179,716,,Dr_Shotgun_Phd,-1,8,23,26%,31,2023/04/05
2180,714,,HawkNoire,-8,1,10,9%,11,2023/04/06
2181,714,,nuns323,-5,2,11,15%,13,2023/04/16
2182,714,,Sh4d0w [NL],-2,3,12,20%,15,2023/04/12
2183,714,,Infidel,+1,2,10,17%,12,2023/03/22
2184,713,,chris.shieh2020,+1,4,15,21%,19,2023/04/18
2185,712,,MILK,-4,5,17,23%,22,2023/04/10
2186,705,,aaaDARKxVOID,-1,5,16,24%,21,2023/04/16
2187,704,,vitaegis,-2,37,63,37%,100,2023/04/07
2188,703,,Kradune,-3,4,18,18%,22,2023/04/17
2189,703,,syk900,-4,6,18,25%,24,2023/04/16
2190,703,,报应死仔阿痿骡,-2,4,14,22%,18,2023/04/17
2191,701,,manu_belmote,-4,2,13,13%,15,2023/04/17
2192,700,,Laredo,+1,6,21,22%,27,2023/04/16
2193,699,,donald_from_duckburg,-4,14,30,32%,44,2023/04/13
2194,699,,SpiritsZ,-9,2,11,15%,13,2023/04/04
2195,699,,You got 北部粽,-1,2,10,17%,12,2023/04/01
2196,698,,Clopticon,-1,2,11,15%,13,2023/04/07
2197,697,,General_Green,-10,0,10,0%,10,2023/04/15
2198,695,,Z3ffyR,-4,2,10,17%,12,2023/04/12
2199,692,,King Ryder II,+1,13,38,25%,51,2023/03/27
2200,691,,adam.upton56,-2,4,19,17%,23,2023/03/29
2201,690,,MENTALLY ILL LIL SQUARE BUB,-2,10,27,27%,37,2023/04/17
2202,688,,j18el,-4,21,53,28%,74,2023/04/18
2203,685,,Mr.CrazyPerson,-9,1,10,9%,11,2023/04/04
2204,685,,[MG] BulletDispenser,-2,20,48,29%,68,2023/04/03
2205,685,,Maleven,-3,19,39,33%,58,2023/04/15
2206,683,,Nightfury0407,-5,1,9,10%,10,2023/04/08
2207,683,,Jordan57250,-3,2,10,17%,12,2023/04/16
2208,680,,Rurin,-10,0,10,0%,10,2023/04/01
2209,679,,Llamafood,-2,2,11,15%,13,2023/03/30
2210,676,,neocookie,-1,9,19,32%,28,2023/03/22
2211,673,,ColonelMustardGas,-5,6,18,25%,24,2023/04/17
2212,673,,chabanne.cyril,-1,1,14,7%,15,2023/04/13
2213,671,,牛人,-1,34,83,29%,117,2023/04/16
2214,670,,dirtydanes2013,-1,3,12,20%,15,2023/03/28
2215,668,,v.ultscher,-2,6,25,19%,31,2023/04/04
2216,665,,Cyb/R,+1,4,15,21%,19,2023/04/16
2217,664,,Jayce The Doe,+1,62,83,43%,145,2023/04/17
2218,664,,freeclimber,-11,5,20,20%,25,2023/04/08
2219,662,,Mountainman,-2,5,21,19%,26,2023/04/06
2220,661,,samyzkimo,-2,10,28,26%,38,2023/03/21
2221,661,,Alien,-1,4,23,15%,27,2023/04/03
2222,660,,Goulaschkanone,-2,24,51,32%,75,2023/04/13
2223,656,,Powertime,-10,1,13,7%,14,2023/03/22
2224,655,,Life_Insense,-2,13,34,28%,47,2023/04/17
2225,655,,MarRei0407,+1,14,41,25%,55,2023/04/16
2226,654,,Trumpf,-2,1,10,9%,11,2023/04/05
2227,650,,迷失之奥拉夫,-5,3,17,15%,20,2023/04/07
2228,649,,karl.lacroix,-2,7,21,25%,28,2023/04/17
2229,645,,KarlRasur,-10,2,14,13%,16,2023/04/01
2230,640,,stanthezebra,-1,10,35,22%,45,2023/04/13
2231,637,,tobyteng,+1,5,18,22%,23,2023/04/17
2232,637,,s.o.s,-14,2,21,9%,23,2023/03/30
2233,636,,W3rw0lf,-5,2,18,10%,20,2023/04/13
2234,632,,ricar_mertxe,-5,3,18,14%,21,2023/03/29
2235,629,,christianln1,+1,20,68,23%,88,2023/04/16
2236,627,,Sparky Harold,-8,19,50,28%,69,2023/04/17
2237,624,,FuzzyDunlop81,-2,4,23,15%,27,2023/04/04
2238,621,,educastillospain,+2,14,62,18%,76,2023/04/17
2239,611,,landy5,-9,1,14,7%,15,2023/04/15
2240,609,,爱念痛,-4,18,88,17%,106,2023/04/10
2241,603,,Tomy_CAT,-10,1,13,7%,14,2023/04/13
2242,599,,Veeh Youtube,-7,8,35,19%,43,2023/04/16
2243,599,,brad_007,+1,35,127,22%,162,2023/04/17
2244,597,,HENNINGHK,-10,0,10,0%,10,2023/03/31
2245,595,,Fafnir,-1,3,20,13%,23,2023/04/01
2246,593,,m0t0r,-4,16,44,27%,60,2023/04/16
2247,592,,Shunkiz *TanKKK*,-6,1,13,7%,14,2023/03/30
2248,579,,Pete^,-3,2,15,12%,17,2023/04/07
2249,570,,SirOwnsAlot,-10,13,41,24%,54,2023/04/09
2250,566,,778708221,+1,3,23,12%,26,2023/04/11
2251,552,,mazerati4,-10,3,25,11%,28,2023/04/13
2252,552,,derrick_dutchy,-14,0,14,0%,14,2023/04/17
2253,549,,BLACKJESTER541,-17,0,17,0%,17,2023/04/12
2254,547,,joerg_horstmann,-20,1,24,4%,25,2023/04/06
2255,531,,egg1head™,-7,17,87,16%,104,2023/04/15
2256,527,,kundernietsvan,-18,0,18,0%,18,2023/04/15
