RANK,ELO,LEVEL,ALIAS,STREAK,WINS,LOSSES,RATIO,TOTAL,LAST GAME
1,1781,,‡∏´‡∏•‡∏ß‡∏á‡∏õ‡∏π‡πà‡πÄ‡∏ì‡∏£,+58,233,46,84%,279,2023/04/08
2,1768,,Mickey,+11,82,18,82%,100,2023/03/26
3,1731,,Amita,+11,156,23,87%,179,2023/04/17
4,1718,,Rei,+4,126,9,93%,135,2023/03/31
5,1655,,ashilrye,+7,258,38,87%,296,2023/04/17
6,1654,,Jibber,+3,95,14,87%,109,2023/04/08
7,1646,,Estocade Gaming YT,+43,106,31,77%,137,2023/04/16
8,1621,,Hallelujah,+42,175,27,87%,202,2023/04/17
9,1617,,Jesus is My Saviour,+23,60,3,95%,63,2023/04/10
10,1609,,Frontyard man,+1,70,15,82%,85,2023/03/28
11,1575,,night_raven0203,+27,185,66,74%,251,2023/04/17
12,1569,,Treadz,+16,351,100,78%,451,2023/04/14
13,1567,,EL ZULU,+15,48,11,81%,59,2023/04/17
14,1566,,F3riG,+4,51,10,84%,61,2023/04/16
15,1565,,Backyard man,+18,67,6,92%,73,2023/03/28
16,1561,,Charlotte,+6,260,105,71%,365,2023/04/17
17,1561,,elpern,+4,69,21,77%,90,2023/04/17
18,1557,,FloatingC,+12,85,18,83%,103,2023/03/28
19,1552,,xFidde,+16,69,21,77%,90,2023/04/15
20,1551,,BrainSplat | HulkSMASH,+25,55,10,85%,65,2023/04/14
21,1541,,havoc,-1,111,24,82%,135,2023/04/17
22,1538,,Orangepest,+3,64,17,79%,81,2023/04/17
23,1535,,S205,+2,122,25,83%,147,2023/04/17
24,1520,,The101stAirBorne,+7,81,23,78%,104,2023/04/17
25,1513,,momo4sho,-2,107,31,78%,138,2023/04/15
26,1512,,vwvc,+1,42,13,76%,55,2023/04/17
27,1507,,W00tLeLBrrrrrrrrrrrrrr,+11,88,25,78%,113,2023/04/10
28,1507,,[EPIC]gogy,+12,136,54,72%,190,2023/04/12
29,1493,,[Peanut] Caosak,+1,38,11,78%,49,2023/04/16
30,1491,,Theodosios,+3,50,14,78%,64,2023/04/07
31,1478,,nub,+6,21,3,88%,24,2023/03/28
32,1476,,DumaisTV,-1,64,19,77%,83,2023/04/11
33,1475,,FBI OPEN UP,+9,241,153,61%,394,2023/04/17
34,1474,,¬∞NOSMarkov.-,-2,55,22,71%,77,2023/03/30
35,1472,,üêºüêºKashllüêºüêº,+7,197,111,64%,308,2023/04/17
36,1470,,odung,+2,35,10,78%,45,2023/04/16
37,1465,,PutPut - AusarTheVile,+18,25,4,86%,29,2023/04/17
38,1465,,K. Ronaldo,+1,93,35,73%,128,2023/03/31
39,1459,,The Angry Dutchman,+2,52,17,75%,69,2023/04/17
40,1458,,rrrr4201,+14,113,45,72%,158,2023/04/11
41,1453,,Nicko,-1,41,11,79%,52,2023/04/10
42,1451,,Siberian,+4,67,31,68%,98,2023/04/15
43,1443,,fiadaputa,+6,107,64,63%,171,2023/04/16
44,1441,,oziligath,+2,93,44,68%,137,2023/04/17
45,1437,,CptLink( jimmy),+1,68,25,73%,93,2023/04/01
46,1436,,MajorKusaetNogi,+6,38,10,79%,48,2023/03/24
47,1433,,Sovereign,+12,47,12,80%,59,2023/03/24
48,1433,,salmonTA,+6,37,12,76%,49,2023/04/17
49,1430,,Deep‚ôÇDark‚ôÇFantasy,+9,50,23,68%,73,2023/03/28
50,1430,,Quack,+12,72,32,69%,104,2023/04/16
51,1429,,‰ªäÂ§úËñÑÈõæ,+4,33,7,83%,40,2023/04/16
52,1425,,ÔπåÂ§ïÈôΩ„ÅÆ‰ΩôÊ∫´„Å•,-1,77,36,68%,113,2023/04/17
53,1423,,IMBAoracle,+6,19,2,90%,21,2023/03/27
54,1421,,Happycat,+5,13,2,87%,15,2023/03/31
55,1418,,The Sloth,-1,71,25,74%,96,2023/04/03
56,1416,,TomCat,+1,23,6,79%,29,2023/03/25
57,1411,,[PAX Sqd.] PAX AJAX,-1,229,122,65%,351,2023/04/15
58,1410,,[Peanut] Calyon,-1,37,12,76%,49,2023/04/17
59,1409,,JLODGE,+1,36,10,78%,46,2023/04/18
60,1406,,cat tank,+5,38,13,75%,51,2023/04/11
61,1400,,Equuz,+4,44,18,71%,62,2023/04/14
62,1399,,TarNationZ,+1,16,4,80%,20,2023/03/30
63,1399,,vegetabledoge,-2,88,39,69%,127,2023/04/08
64,1398,,RuberGruber,-1,87,40,69%,127,2023/03/28
65,1397,,lattouf,+4,59,27,69%,86,2023/04/16
66,1396,,Farlion,+6,47,21,69%,68,2023/04/15
67,1395,,CoH2 sucks,-2,80,40,67%,120,2023/04/12
68,1395,,BaByuByu,+1,62,23,73%,85,2023/04/11
69,1393,,Leiarde,+13,31,6,84%,37,2023/03/23
70,1393,,DexN,-2,227,125,64%,352,2023/04/15
71,1389,,Mordo47,+11,29,9,76%,38,2023/03/26
72,1387,,Ra11,-1,34,11,76%,45,2023/03/31
73,1386,,StephennJF,+1,162,85,66%,247,2023/04/17
74,1384,,M0nItor,+2,22,4,85%,26,2023/04/18
75,1382,,I just read the book list,+9,61,30,67%,91,2023/03/25
76,1381,,drachwal91,+3,214,173,55%,387,2023/04/18
77,1380,,Mr.Brightside,+8,13,1,93%,14,2023/03/23
78,1380,,xiaomo,+3,19,4,83%,23,2023/04/05
79,1380,,Boomgoesthedynamite,+3,103,65,61%,168,2023/04/17
80,1379,,Jade Buddha,+1,45,19,70%,64,2023/04/17
81,1379,,Hybris,+1,35,10,78%,45,2023/03/29
82,1378,,T.R. 3nder,+4,35,15,70%,50,2023/04/04
83,1378,,JiuMi,+3,49,24,67%,73,2023/04/06
84,1376,,Bad Ash,+5,90,51,64%,141,2023/04/17
85,1371,,Brits Unplayable-Give Sniper,+3,80,43,65%,123,2023/03/25
86,1370,,tagilla,+9,29,10,74%,39,2023/04/08
87,1369,,DanielD,+2,10,1,91%,11,2023/04/14
88,1368,,[L2P]BartonPL,+7,14,1,93%,15,2023/04/10
89,1368,,IntegralSweeD,-1,29,12,71%,41,2023/04/02
90,1366,,Èò¥Èô©ÊÅ∂ÊØíÁÜä‰∏ª‰ªª,+4,32,9,78%,41,2023/03/24
91,1366,,MP_HappyPanther,-1,15,5,75%,20,2023/04/11
92,1365,,Imbbe,-2,53,23,70%,76,2023/04/08
93,1361,,MinigunSC,-2,24,5,83%,29,2023/04/07
94,1358,,Twitch Yunicone‚â†‚â†Pony,+9,59,26,69%,85,2023/04/14
95,1358,,ohmygod321,+2,53,30,64%,83,2023/04/01
96,1358,,LENS,+2,34,12,74%,46,2023/03/28
97,1357,,Madkitty,+4,335,215,61%,550,2023/04/05
98,1357,,TheChosen,+1,53,21,72%,74,2023/03/27
99,1355,,-RŒª“âinyCloudCore,-1,20,7,74%,27,2023/04/11
100,1354,,Inverse,+1,45,22,67%,67,2023/04/16
101,1353,,akutoku,+1,69,41,63%,110,2023/04/15
102,1353,,Pinhead Larry,+3,90,67,57%,157,2023/04/17
103,1352,,Skadi,+2,163,88,65%,251,2023/04/17
104,1352,,Jelly Bean,+2,47,20,70%,67,2023/04/07
105,1351,,Tiefflieger,+3,31,15,67%,46,2023/04/10
106,1349,,JZuna,+2,15,4,79%,19,2023/03/30
107,1349,,CheeseTonkatsu,+10,17,3,85%,20,2023/04/01
108,1348,,iaguz,+1,18,5,78%,23,2023/03/25
109,1347,,-NSO- Hon3ynuts,+10,13,2,87%,15,2023/03/30
110,1346,,Nostalgia93',+3,38,17,69%,55,2023/04/13
111,1344,,Enterprise Œ©,+4,24,7,77%,31,2023/04/15
112,1344,,LemonMint,+1,17,3,85%,20,2023/04/05
113,1342,,Veyx_,+1,230,135,63%,365,2023/04/17
114,1341,,„ÄéBlackBear„Äè,+4,11,2,85%,13,2023/04/11
115,1341,,Adadis,+5,69,45,61%,114,2023/04/12
116,1339,,Tassos117,+15,45,22,67%,67,2023/04/11
117,1339,,NANAMI,+2,42,18,70%,60,2023/04/07
118,1338,,Niklas,+3,11,1,92%,12,2023/04/08
119,1338,,Finndeed,+2,20,7,74%,27,2023/04/05
120,1335,,Zenabauer,+5,34,18,65%,52,2023/04/11
121,1335,,Cheezus,+1,140,82,63%,222,2023/04/14
122,1335,,76561197972578478,+1,42,19,69%,61,2023/04/17
123,1335,,Sunny,+4,11,1,92%,12,2023/04/10
124,1334,,normad,+3,24,8,75%,32,2023/04/09
125,1333,,El Dorado,-2,83,51,62%,134,2023/04/15
126,1333,,DarkAlric,+4,64,38,63%,102,2023/04/17
127,1331,,Johnny 99,+3,32,12,73%,44,2023/04/15
128,1331,,SMOKO,+10,10,0,100%,10,2023/03/22
129,1329,,DumbassTV,+1,10,1,91%,11,2023/04/12
130,1327,,Toiletguy,-1,13,1,93%,14,2023/03/29
131,1327,,pidzi,+5,66,37,64%,103,2023/04/17
132,1326,,NickDaTrojan,+1,40,16,71%,56,2023/04/17
133,1326,,sam,+3,27,12,69%,39,2023/03/28
134,1325,,ciamgyic,+2,250,182,58%,432,2023/04/11
135,1325,,Snitch,-1,33,9,79%,42,2023/04/10
136,1325,,Vector,-2,9,2,82%,11,2023/04/17
137,1325,,Ondross,+5,10,1,91%,11,2023/03/24
138,1325,,7pUpU,+2,102,66,61%,168,2023/04/17
139,1323,,bigfriendlybert,+1,17,6,74%,23,2023/04/01
140,1323,,Lazy Ren,-2,11,2,85%,13,2023/03/22
141,1321,,Luvnest,-1,29,13,69%,42,2023/04/12
142,1321,,—äÔ≠ÅÔ≠Å‚Åø¬ªStoffa,+3,111,69,62%,180,2023/04/17
143,1320,,Souless and Heartless Monkey Man,-1,44,26,63%,70,2023/04/08
144,1319,,Watson,+2,46,29,61%,75,2023/04/17
145,1319,,.Hesko.,-1,85,45,65%,130,2023/04/16
146,1318,,Herr Blautier,+1,119,73,62%,192,2023/04/16
147,1318,,KyrreLubiWodƒô,+10,24,11,69%,35,2023/04/11
148,1318,,a hell on earth,-1,27,13,68%,40,2023/04/09
149,1317,,TRI1091,-1,27,13,68%,40,2023/03/24
150,1316,,Authoritarrr,+2,24,11,69%,35,2023/04/08
151,1316,,SturmTigerGiap,+2,69,30,70%,99,2023/03/31
152,1312,,eMBeLeS,+1,15,3,83%,18,2023/04/03
153,1312,,Elisabeth Eugenie,+3,61,29,68%,90,2023/03/27
154,1308,,Dugo,+1,21,9,70%,30,2023/04/14
155,1308,,Triggler,+2,19,7,73%,26,2023/04/05
156,1308,,rahcesene,+2,11,2,85%,13,2023/03/21
157,1308,,ÁôΩËµ∑,-2,33,10,77%,43,2023/04/02
158,1307,,Logys P,-1,18,6,75%,24,2023/04/13
159,1307,,Vesat Eiwalter,+4,77,63,55%,140,2023/04/09
160,1307,,VonAsten,-1,10,2,83%,12,2023/04/13
161,1307,,Tuta,+3,37,14,73%,51,2023/04/15
162,1305,,RyuJou,-1,15,5,75%,20,2023/04/11
163,1304,,Refero,+5,9,1,90%,10,2023/04/10
164,1304,,Vector,+1,17,7,71%,24,2023/04/15
165,1303,,TwistedTootsy,+5,32,17,65%,49,2023/04/13
166,1303,,swdertfht,+5,12,3,80%,15,2023/04/14
167,1303,,OHxYEAHxJNP,+3,28,14,67%,42,2023/04/14
168,1302,,Ï∞∞ÏßÄÍµ¨ÎÇò,+5,197,140,58%,337,2023/04/17
169,1301,,shisty44,+2,82,64,56%,146,2023/03/31
170,1300,,cvvonly,-2,37,13,74%,50,2023/03/28
171,1299,,LostsKy_Deity,+2,150,100,60%,250,2023/04/14
172,1299,,CUBYX,-2,95,72,57%,167,2023/04/02
173,1299,,Watchmedothis,+7,64,35,65%,99,2023/04/16
174,1299,,RedClownLips,+5,32,17,65%,49,2023/04/15
175,1299,,VulcanHDGaming No.1 Fan,-4,10,6,63%,16,2023/04/01
176,1298,,PunisHer1638,-1,45,22,67%,67,2023/04/16
177,1296,,himynameisho,+1,46,24,66%,70,2023/04/11
178,1296,,1337 HAXX0R,+3,43,24,64%,67,2023/04/09
179,1296,,WouldULike2BeAPepper2?,-1,74,50,60%,124,2023/04/15
180,1295,,smallNhii,-2,108,71,60%,179,2023/04/17
181,1294,,ouchouch,-2,70,43,62%,113,2023/04/01
182,1294,,^1Soldat^0James,+3,30,11,73%,41,2023/04/08
183,1292,,Jae,-1,22,8,73%,30,2023/04/01
184,1292,,cohmod,+1,19,10,66%,29,2023/04/16
185,1291,,SturmTigerGoat,+15,22,7,76%,29,2023/03/22
186,1291,,Vector,+3,29,13,69%,42,2023/04/17
187,1291,,Empa,+6,55,28,66%,83,2023/04/16
188,1290,,Blue Bear,+1,11,2,85%,13,2023/04/07
189,1290,,Sweet Pea,-1,63,39,62%,102,2023/04/12
190,1289,,Dragoon,+1,42,22,66%,64,2023/03/22
191,1289,,Trainzz,-1,36,18,67%,54,2023/04/18
192,1289,,LoopDloop,+6,23,11,68%,34,2023/03/23
193,1289,,DaPopeCOH,-1,18,6,75%,24,2023/04/08
194,1288,,Zyswen,+3,16,5,76%,21,2023/04/16
195,1288,,Tobis,-1,9,3,75%,12,2023/04/14
196,1287,,Exerate,+2,24,10,71%,34,2023/04/10
197,1286,,V_l_a_d_o_V ‚Ñ†,-3,57,34,63%,91,2023/04/09
198,1285,,[EL] Senpai Ares,+1,19,7,73%,26,2023/04/07
199,1285,,PaniC-.-,+3,10,2,83%,12,2023/04/06
200,1285,,FK9DD,+2,63,35,64%,98,2023/04/14
201,1285,,Hidzaro,+1,15,5,75%,20,2023/04/15
202,1285,,AHOIENMQ,-1,22,7,76%,29,2023/03/26
203,1284,,OnCe_Ov3R,-2,150,112,57%,262,2023/04/02
204,1283,,Bulat,-1,27,13,68%,40,2023/04/01
205,1282,,Pony by Nature,+2,13,4,76%,17,2023/04/15
206,1281,,TowerNumberNine,-1,91,73,55%,164,2023/04/15
207,1281,,GenObi,+1,111,81,58%,192,2023/04/16
208,1281,,Blackman!!!,+5,33,14,70%,47,2023/03/28
209,1281,,Kroll,+3,45,31,59%,76,2023/04/17
210,1280,,‚Ñé ‚ÑØ ‚Ñõ ‚Ñ¥‚Ñ¢ÁæûÊ∂©ÁöÑ‰ø°Â∞Å,-2,169,123,58%,292,2023/04/17
211,1280,,Increase,+1,115,83,58%,198,2023/04/16
212,1279,,lush_meadow,+6,13,3,81%,16,2023/04/17
213,1279,,Green B√©ret,+4,14,5,74%,19,2023/04/13
214,1279,,cblanco ‚òÖ,+5,16,4,80%,20,2023/03/25
215,1279,,Snoopa,+1,30,15,67%,45,2023/04/14
216,1277,,tightrope,+1,28,14,67%,42,2023/04/14
217,1276,,.:PSG:. RedxWings,-1,57,38,60%,95,2023/04/17
218,1275,,Synthsere,+1,71,42,63%,113,2023/04/16
219,1275,,ÁªôÊàë‰∏ÄÈ¢óÊòü,-1,58,35,62%,93,2023/04/01
220,1274,,[ACES].MaxHoang,+3,57,36,61%,93,2023/04/17
221,1273,,SkYisTheLimiT,-3,21,9,70%,30,2023/03/31
222,1272,,gilashley,+1,11,3,79%,14,2023/03/25
223,1270,,Crovax,-1,19,6,76%,25,2023/03/31
224,1270,,ahegao blade,-4,16,7,70%,23,2023/04/03
225,1270,,Harold H,-3,35,18,66%,53,2023/04/15
226,1269,,nystrom,-2,83,43,66%,126,2023/04/17
227,1269,,NoBugJustSkill,+3,95,59,62%,154,2023/04/17
228,1269,,Penetron2000,+3,46,27,63%,73,2023/04/16
229,1268,,A1_Prospectors,-1,8,2,80%,10,2023/04/07
230,1267,,Dr. Jekyll,-2,8,3,73%,11,2023/04/12
231,1267,,Jeep Enjoyer,-1,219,164,57%,383,2023/04/18
232,1267,,Bufftin,+4,13,3,81%,16,2023/04/09
233,1266,,Â∞èËäô‰∏ΩÂ®Ö,-2,45,24,65%,69,2023/03/29
234,1265,,Imperates,-1,64,48,57%,112,2023/04/06
235,1265,,50584sh,+1,39,22,64%,61,2023/04/15
236,1264,,LaDin2,-1,15,8,65%,23,2023/03/24
237,1264,,Contador,+2,50,41,55%,91,2023/04/10
238,1264,,Gravemouth,+6,10,2,83%,12,2023/03/25
239,1264,,Darunjia,+2,29,14,67%,43,2023/03/29
240,1264,,Jimbob2121,+6,45,27,63%,72,2023/03/30
241,1263,,BananaInPajamas,+1,13,7,65%,20,2023/04/17
242,1263,,Virgile[FR],+6,13,2,87%,15,2023/04/15
243,1262,,CristianRonaldoOfCoh2,+4,11,3,79%,14,2023/03/28
244,1262,,BeeFat,+3,10,3,77%,13,2023/04/08
245,1262,,MR_BLORB,-2,78,50,61%,128,2023/04/17
246,1261,,[KSG] Blackwing,+3,29,20,59%,49,2023/04/17
247,1260,,Khan,+6,14,5,74%,19,2023/04/17
248,1260,,Bucho Burns,+4,12,6,67%,18,2023/03/25
249,1260,,IIIIIIIIIII7,+9,9,2,82%,11,2023/03/27
250,1259,,FuzZiioN,+3,22,11,67%,33,2023/04/01
251,1259,,LB,-1,25,11,69%,36,2023/04/17
252,1259,,WebsterBolek,-2,13,6,68%,19,2023/04/12
253,1259,,Microsoft Word,-1,11,2,85%,13,2023/04/02
254,1257,,bog,+7,45,29,61%,74,2023/03/30
255,1257,,2506Brigade,+2,10,2,83%,12,2023/04/10
256,1257,,ranger,-1,103,83,55%,186,2023/04/12
257,1257,,Enemy,+2,15,4,79%,19,2023/04/14
258,1257,,Tiltimus Prime,+4,115,93,55%,208,2023/04/11
259,1256,,matwyr,-1,24,13,65%,37,2023/04/17
260,1255,,Clororaa,+3,11,3,79%,14,2023/03/30
261,1255,,Kaduin,+7,52,34,60%,86,2023/04/10
262,1255,,Frost,+7,14,5,74%,19,2023/04/04
263,1254,,Otvor,-1,58,32,64%,90,2023/04/10
264,1254,,È∏°È•≤ÊñôÈîêËØÑÂÜúÂú∫‰∏ª,+1,54,41,57%,95,2023/04/13
265,1253,,BlueSkidrow,+1,13,4,76%,17,2023/04/10
266,1253,,xbubalo,+1,32,14,70%,46,2023/04/16
267,1253,,Imperial Dane,-4,13,7,65%,20,2023/04/14
268,1251,,asd 546,+3,43,25,63%,68,2023/04/05
269,1249,,Ulrich,-1,22,15,59%,37,2023/03/27
270,1249,,Panzerfaust,-1,73,53,58%,126,2023/04/15
271,1248,,Noah,+1,11,5,69%,16,2023/03/25
272,1248,,PanzerGrenadier,-2,36,24,60%,60,2023/04/17
273,1248,,AceHiro,-1,41,22,65%,63,2023/04/04
274,1248,,Ho Lee Fuk,+2,24,11,69%,35,2023/04/03
275,1247,,wile,+3,10,4,71%,14,2023/03/27
276,1247,,Noob Nath,+6,58,39,60%,97,2023/04/17
277,1247,,Fortune,+5,12,4,75%,16,2023/04/16
278,1247,,Jensen,-1,13,4,76%,17,2023/03/21
279,1246,,ChocolateStarfish,+3,17,6,74%,23,2023/04/17
280,1246,,Rasler63,+2,33,18,65%,51,2023/04/04
281,1245,,DDÈüø,+2,14,7,67%,21,2023/04/12
282,1245,,SexPistole,+3,32,16,67%,48,2023/04/12
283,1244,,panther,-5,34,16,68%,50,2023/04/10
284,1243,,DC„ÉÉ,+1,9,3,75%,12,2023/04/05
285,1243,,Trademark,+4,15,6,71%,21,2023/03/23
286,1243,,Manupktd,+2,54,36,60%,90,2023/04/07
287,1243,,ChuaMC,+2,73,55,57%,128,2023/04/17
288,1242,,Commissaire Gropopov,-1,10,3,77%,13,2023/03/25
289,1242,,Rechter Winkel,-1,66,42,61%,108,2023/04/02
290,1242,,Dominik,+3,12,4,75%,16,2023/04/10
291,1242,,IpKaiFung,-2,23,15,61%,38,2023/04/18
292,1241,,Redhorrn,-1,8,2,80%,10,2023/03/30
293,1241,,That Guy!,+6,42,26,62%,68,2023/03/23
294,1241,,Schreihalz Œõ,+2,12,4,75%,16,2023/04/04
295,1240,,RICO,+3,21,9,70%,30,2023/03/31
296,1240,,Guziol#,+2,10,2,83%,12,2023/04/15
297,1238,,Airandfelt,+3,11,4,73%,15,2023/04/07
298,1238,,Luckeeey,-1,15,10,60%,25,2023/04/15
299,1238,,Hachald,+3,58,38,60%,96,2023/04/16
300,1238,,N0o2,-2,54,43,56%,97,2023/03/21
301,1238,,TestingWarHead,-1,19,8,70%,27,2023/03/25
302,1237,,Mr. Fahrenheit,+6,91,62,59%,153,2023/04/04
303,1237,,suzune[JP],+1,21,8,72%,29,2023/03/25
304,1237,,Dullahan,+1,47,32,59%,79,2023/04/15
305,1236,,SKT,+1,10,3,77%,13,2023/03/31
306,1236,,RangerChooban,+1,32,19,63%,51,2023/04/13
307,1236,,HIBBLE,-1,18,7,72%,25,2023/03/23
308,1235,,-CK-,+3,98,80,55%,178,2023/03/22
309,1235,,Wheezy Yeezy,+3,9,2,82%,11,2023/04/01
310,1235,,Jeiseun,+4,42,29,59%,71,2023/04/06
311,1235,,Angry Android,+1,15,8,65%,23,2023/03/26
312,1235,,BreadMarshLivePlace,-2,46,33,58%,79,2023/04/10
313,1235,,Hanwoomul,+4,11,3,79%,14,2023/04/07
314,1234,,KlausurenSohn,-1,18,9,67%,27,2023/03/25
315,1233,,Shawman,-2,53,36,60%,89,2023/04/17
316,1232,,‚ô•rcOrz,-2,45,40,53%,85,2023/03/22
317,1232,,JaminROCK,-1,25,16,61%,41,2023/03/21
318,1232,,Lanfeust,+1,48,32,60%,80,2023/04/01
319,1232,,mustachewarfare,-1,8,2,80%,10,2023/03/27
320,1231,,Begbie,+4,10,3,77%,13,2023/04/12
321,1231,,Stormless,+4,26,10,72%,36,2023/04/17
322,1230,,Sandwichtogo,-1,53,36,60%,89,2023/04/15
323,1230,,Interloper,-2,155,120,56%,275,2023/04/17
324,1229,,folder,+4,81,72,53%,153,2023/04/07
325,1228,,aBurningDog,+5,35,28,56%,63,2023/03/21
326,1228,,women respecter,-1,13,6,68%,19,2023/04/07
327,1228,,XQC,-1,9,3,75%,12,2023/04/06
328,1228,,Lifer,+7,20,9,69%,29,2023/04/12
329,1227,,MightyMouseJHM,+2,23,15,61%,38,2023/04/17
330,1226,,bisivan1,+1,28,14,67%,42,2023/04/16
331,1226,,A1_Prospector,+2,9,4,69%,13,2023/03/26
332,1226,,Screaming EAGLE,+3,16,8,67%,24,2023/04/01
333,1226,,DIRTY_FISHERMAN,-1,9,3,75%,12,2023/04/06
334,1226,,VindicareX,+5,60,45,57%,105,2023/04/06
335,1226,,davidj217,-1,23,14,62%,37,2023/04/04
336,1225,,Reakly,-1,60,33,65%,93,2023/04/16
337,1225,,Chillin,-4,39,22,64%,61,2023/04/08
338,1224,,Chiico,+1,13,5,72%,18,2023/03/30
339,1224,,Crusader From The Future,+2,75,58,56%,133,2023/04/14
340,1223,,FooKilla,+11,110,84,57%,194,2023/04/18
341,1223,,Arricio,+1,8,3,73%,11,2023/04/11
342,1223,,Pinky```,-1,141,106,57%,247,2023/04/10
343,1222,,[EL] TheVongKong,-1,17,9,65%,26,2023/04/04
344,1222,,CupcakeOfDeath,+1,10,4,71%,14,2023/04/12
345,1222,,Cheroid,+2,24,16,60%,40,2023/04/01
346,1221,,Eviltown103,-1,18,10,64%,28,2023/04/06
347,1221,,Quadro,+1,14,8,64%,22,2023/04/03
348,1220,,101st.Airbone,-1,12,5,71%,17,2023/04/14
349,1220,,Apoptosis,-1,7,3,70%,10,2023/03/30
350,1219,,Lanre92,+1,56,37,60%,93,2023/04/16
351,1219,,(KCC)TongTongBoy,-3,38,28,58%,66,2023/04/04
352,1218,,HasBeenDropped,-3,10,6,63%,16,2023/04/13
353,1217,,yapster,+4,11,5,69%,16,2023/04/16
354,1217,,Sosorryman,+2,8,2,80%,10,2023/04/14
355,1216,,Extra Hawt,-1,13,7,65%,20,2023/04/09
356,1215,,VndctL,-2,58,37,61%,95,2023/04/12
357,1215,,Neko,-2,19,11,63%,30,2023/04/01
358,1215,,aSIISymbiosis,+3,29,15,66%,44,2023/04/17
359,1215,,Project Reality King,+7,28,17,62%,45,2023/03/26
360,1215,,AHungryPigeon,-2,56,39,59%,95,2023/04/01
361,1214,,crosseazain,+3,36,23,61%,59,2023/04/11
362,1214,,Stryker,+1,30,18,63%,48,2023/04/17
363,1213,,Trauma,+5,29,17,63%,46,2023/03/21
364,1213,,Storm,+12,26,13,67%,39,2023/04/12
365,1213,,Bug,+1,16,10,62%,26,2023/03/26
366,1211,,Tomakaze,+2,9,3,75%,12,2023/03/31
367,1211,,Manitou,+1,30,20,60%,50,2023/04/10
368,1211,,AYIK 01,-1,8,2,80%,10,2023/04/11
369,1211,,Zaterner,+8,13,4,76%,17,2023/04/01
370,1210,,GeeNo,+2,14,8,64%,22,2023/04/08
371,1210,,Templariusz,-1,15,6,71%,21,2023/04/01
372,1210,,Kamikaze Scotsman,-2,29,17,63%,46,2023/04/10
373,1209,,Maru,+1,34,20,63%,54,2023/04/13
374,1209,,76561198046408390,+8,37,27,58%,64,2023/03/30
375,1209,,BlackAz,-1,9,4,69%,13,2023/04/16
376,1208,,Malevolent Pink Cat,-4,12,6,67%,18,2023/04/13
377,1208,,yesman55,+5,26,15,63%,41,2023/03/30
378,1208,,Lt Beren,-1,46,29,61%,75,2023/04/17
379,1207,,Edward,+4,51,32,61%,83,2023/03/31
380,1207,,BusinessBryce,+2,21,10,68%,31,2023/04/10
381,1206,,turkey cat,+7,20,10,67%,30,2023/04/15
382,1205,,Peacemaker,+2,25,16,61%,41,2023/04/17
383,1204,,NaseMabi,-2,10,5,67%,15,2023/04/09
384,1204,,Johoni,+7,8,3,73%,11,2023/04/09
385,1204,,TankinatorXD,-1,24,15,62%,39,2023/04/16
386,1204,,"Zoey, Cyberpunk Communist",+7,10,3,77%,13,2023/03/25
387,1204,,ÂæÆÁëï‰πãÂøÉ,+2,26,11,70%,37,2023/03/29
388,1204,,lwl,-4,63,37,63%,100,2023/03/29
389,1203,,CopyCat,+5,29,19,60%,48,2023/04/17
390,1202,,Okeyeg,+4,16,7,70%,23,2023/04/12
391,1202,,juan.aldava,+3,51,33,61%,84,2023/04/11
392,1202,,John Paul II,+6,11,5,69%,16,2023/04/14
393,1202,,UncleClappy,-4,12,7,63%,19,2023/04/10
394,1202,,The Window,+8,19,7,73%,26,2023/04/08
395,1201,,69apm,-2,6,4,60%,10,2023/04/12
396,1201,,JackTW The VTUBER,+1,28,19,60%,47,2023/04/03
397,1201,,Guessmaname,+1,104,75,58%,179,2023/04/17
398,1201,,Iron_Sarge69,+1,17,9,65%,26,2023/04/12
399,1201,,lePepsi,-1,28,16,64%,44,2023/04/12
400,1200,,dire,+2,249,205,55%,454,2023/04/18
401,1200,,Azakura,+5,19,10,66%,29,2023/04/13
402,1200,,CNposition,-4,9,6,60%,15,2023/04/04
403,1200,,VitaminP,-3,21,17,55%,38,2023/04/08
404,1199,,[GER]KaiWer94,+1,17,9,65%,26,2023/04/04
405,1199,,Faramir,+1,38,32,54%,70,2023/04/05
406,1198,,Artanis,-1,7,3,70%,10,2023/03/30
407,1198,,Lieut‚ú™LunchBox,-1,19,11,63%,30,2023/04/15
408,1197,,Echo913,+4,10,5,67%,15,2023/04/09
409,1197,,Colonel0tto,+5,15,7,68%,22,2023/04/14
410,1197,,ÊàëÂâë‰πüÊú™Â∞ù‰∏çÂà©,-2,19,11,63%,30,2023/04/16
411,1196,,ZeroUno,+1,9,3,75%,12,2023/03/26
412,1195,,Trivolka,+4,14,6,70%,20,2023/04/15
413,1195,,Kaiser_play,+2,31,16,66%,47,2023/03/29
414,1195,,Fernando87ca,+3,41,27,60%,68,2023/04/11
415,1195,,nonononononononono,+4,15,9,63%,24,2023/04/07
416,1194,,kunlianglin,+1,9,3,75%,12,2023/04/15
417,1193,,Bene,+2,16,7,70%,23,2023/03/26
418,1193,,JoseyWales_,-4,130,95,58%,225,2023/04/06
419,1193,,HomerJ.Simpson,-2,11,4,73%,15,2023/04/16
420,1192,,JustLemon,+2,10,6,63%,16,2023/04/03
421,1192,,Lska,-1,9,4,69%,13,2023/04/05
422,1192,,A-Zizou,-1,8,2,80%,10,2023/03/24
423,1192,,P-Money,+1,12,12,50%,24,2023/04/09
424,1192,,DingDong,+1,13,7,65%,20,2023/03/24
425,1191,,Garzet,-3,9,5,64%,14,2023/04/10
426,1191,,silentbreacher,+3,16,12,57%,28,2023/04/12
427,1190,,Jackatm,+2,18,10,64%,28,2023/04/02
428,1190,,lp,+3,14,7,67%,21,2023/04/16
429,1190,,Etiyen,+3,71,58,55%,129,2023/04/16
430,1189,,Chacineiro,+1,11,4,73%,15,2023/04/04
431,1189,,SaGesH,+5,13,5,72%,18,2023/03/23
432,1189,,Paprikadose.MJ,+1,14,7,67%,21,2023/04/10
433,1188,,Cenovis,+6,14,5,74%,19,2023/04/15
434,1188,,Seraniah,+1,86,67,56%,153,2023/04/16
435,1188,,SShaker,-1,9,5,64%,14,2023/04/06
436,1187,,Dandru,-1,14,8,64%,22,2023/03/26
437,1187,,Birdy,+1,22,12,65%,34,2023/04/15
438,1187,,pooterin,+1,75,52,59%,127,2023/03/28
439,1186,,zhuk0v,+3,33,20,62%,53,2023/04/16
440,1186,,DR4GU,+2,13,7,65%,20,2023/03/27
441,1186,,CommieKillerz,-1,10,7,59%,17,2023/03/30
442,1186,,Seekup,+1,9,4,69%,13,2023/03/31
443,1185,,tubagznyven,+2,22,11,67%,33,2023/04/14
444,1185,,Lady Rytsu,+3,17,12,59%,29,2023/03/22
445,1185,,ohio,+5,17,10,63%,27,2023/03/26
446,1185,,VictorEX,+2,7,3,70%,10,2023/04/08
447,1184,,Sheotek,-1,10,4,71%,14,2023/03/26
448,1184,,ChiefRedSkins,-1,29,20,59%,49,2023/04/15
449,1183,,Thermidor,-3,20,10,67%,30,2023/03/30
450,1182,,maxcov4,+2,19,12,61%,31,2023/03/22
451,1182,,Lukyboom,-1,13,6,68%,19,2023/04/13
452,1182,,[DPRK]DoGGiMan,+1,69,55,56%,124,2023/04/17
453,1182,,William J,-6,49,37,57%,86,2023/04/09
454,1181,,Makros,-1,11,6,65%,17,2023/03/29
455,1181,,Razer,+5,16,7,70%,23,2023/04/13
456,1181,,Mercenary90,+6,12,5,71%,17,2023/04/17
457,1181,,Mas91_IMB,-2,20,13,61%,33,2023/04/11
458,1181,,jamesjamozo,-2,13,9,59%,22,2023/04/04
459,1181,,oki,+5,11,6,65%,17,2023/04/12
460,1180,,Punk McThrust,+1,12,8,60%,20,2023/04/07
461,1180,,Big Busty Sister,+1,22,16,58%,38,2023/04/06
462,1180,,[MF] YourTherapist,+2,12,5,71%,17,2023/04/05
463,1180,,Mr.Kal,-2,13,8,62%,21,2023/04/13
464,1179,,Tubby,-1,18,12,60%,30,2023/04/12
465,1178,,(‚ú∫œâ‚ú∫)chupacabra,+3,7,3,70%,10,2023/04/10
466,1178,,qqwqqp,+1,29,21,58%,50,2023/04/07
467,1178,,Hostis,+3,44,28,61%,72,2023/03/26
468,1177,,MoronPark_The World!,-1,31,24,56%,55,2023/04/17
469,1177,,maousaki,+2,21,12,64%,33,2023/03/26
470,1177,,Auto Man,+4,9,4,69%,13,2023/03/28
471,1176,,emeritus,-2,7,3,70%,10,2023/04/15
472,1176,,üê´üêéüê´üê´üêéüê´üê´üêé,+1,15,10,60%,25,2023/04/04
473,1176,,limewizz,+1,8,3,73%,11,2023/03/30
474,1176,,Wasack,+2,38,31,55%,69,2023/04/15
475,1175,,Mantra,-2,20,14,59%,34,2023/04/14
476,1175,,I was only blinking,+2,29,25,54%,54,2023/04/11
477,1175,,DanteQuaylin,+4,69,57,55%,126,2023/04/16
478,1175,,gumin,+1,12,6,67%,18,2023/03/28
479,1174,,Corvo Attano,+1,57,41,58%,98,2023/03/25
480,1174,,Bundy ‚ô•,-3,35,28,56%,63,2023/04/18
481,1173,,Puffy,-1,23,12,66%,35,2023/04/08
482,1173,,papanash,+2,59,41,59%,100,2023/03/29
483,1173,,RoXoR,+2,12,6,67%,18,2023/03/31
484,1173,,[EL] Brother Captain Specmarine,+1,9,5,64%,14,2023/04/16
485,1173,,HighFive,+2,28,21,57%,49,2023/04/16
486,1173,,Turin,+1,48,42,53%,90,2023/04/12
487,1173,,Atif Abdul Hafeez,+3,15,8,65%,23,2023/04/01
488,1173,,At_Ease,+2,14,9,61%,23,2023/03/27
489,1173,,Rebrovich,-1,10,5,67%,15,2023/04/08
490,1172,,Malenkiy_Apelsin,-3,11,7,61%,18,2023/04/09
491,1171,,Sukulaku,+1,15,8,65%,23,2023/03/30
492,1171,,Heckmek,+1,8,4,67%,12,2023/03/22
493,1170,,Fat Nanny,+1,18,8,69%,26,2023/04/16
494,1170,,Chumps,-1,19,18,51%,37,2023/03/28
495,1169,,FlAyPiGg,+2,30,20,60%,50,2023/04/12
496,1169,,Nesli,-1,17,8,68%,25,2023/04/07
497,1169,,yoonjh591,-2,12,8,60%,20,2023/03/24
498,1169,,Kaypen97,+3,9,4,69%,13,2023/03/25
499,1168,,Metzel,-3,36,30,55%,66,2023/04/08
500,1168,,Tittendachs,-2,8,4,67%,12,2023/04/18
501,1168,,NoMatterWha,-1,15,10,60%,25,2023/04/11
502,1168,,Loading...,+1,7,3,70%,10,2023/04/02
503,1168,,CV33 Tankette,+3,7,3,70%,10,2023/03/25
504,1167,,.Mercury-uK,+2,10,5,67%,15,2023/04/17
505,1167,,K√ºbelwagen!,+1,8,3,73%,11,2023/04/16
506,1167,,CryptX,+1,11,5,69%,16,2023/03/27
507,1167,,Joe‚Ñ¢,-2,11,5,69%,16,2023/04/17
508,1166,,CrackRabbit,+4,164,130,56%,294,2023/04/14
509,1166,,SquishyMuffin,-1,23,15,61%,38,2023/03/24
510,1166,,KURT_,-1,21,15,58%,36,2023/04/15
511,1165,,tank,-1,42,28,60%,70,2023/04/17
512,1165,,DALT11,+4,20,11,65%,31,2023/04/17
513,1164,,Dansara,-3,11,9,55%,20,2023/04/05
514,1164,,Slymanx,-1,28,21,57%,49,2023/04/08
515,1164,,S K E N G,+4,11,6,65%,17,2023/04/01
516,1164,,MyFunction,-1,34,21,62%,55,2023/04/09
517,1164,,Yurdle The Turtle,+1,14,8,64%,22,2023/04/07
518,1164,,Major Striker,+3,10,5,67%,15,2023/04/01
519,1163,,Franz,+2,16,11,59%,27,2023/03/25
520,1163,,-Cr4nk-,+2,8,3,73%,11,2023/04/17
521,1163,,Atlas 91,+1,10,5,67%,15,2023/03/25
522,1162,,Blysk,+1,8,4,67%,12,2023/03/29
523,1162,,ÎÇòÏù¥Ìä∏Ïò§Î∏å,+2,56,47,54%,103,2023/04/13
524,1162,,Slyzor,-4,76,54,58%,130,2023/04/04
525,1162,,Anilasabyss,+1,15,11,58%,26,2023/04/15
526,1162,,MoonLover138,-2,19,10,66%,29,2023/04/14
527,1162,,hellofr13nd,-1,11,6,65%,17,2023/04/11
528,1161,,Assyrian‚ô±,-1,15,9,63%,24,2023/04/01
529,1161,,tommyfoxy,-3,19,11,63%,30,2023/03/24
530,1161,,Stupid Sexy Julian,+2,48,37,56%,85,2023/04/01
531,1161,,Sambo,+2,52,45,54%,97,2023/04/08
532,1160,,‰ºäÂç°Ê¥õÊñØ,-2,13,9,59%,22,2023/04/04
533,1160,,MotoBomb,+2,10,5,67%,15,2023/04/02
534,1160,,Brick,-2,57,41,58%,98,2023/04/17
535,1160,,I Find A Computer Indispensable,-3,30,23,57%,53,2023/04/13
536,1160,,CrazyEight1994,-1,13,8,62%,21,2023/04/12
537,1160,,Drenicak,+4,9,5,64%,14,2023/03/26
538,1160,,WilliamTang,+1,11,5,69%,16,2023/04/16
539,1159,,A-Ê∑åËÄÖÂ¶ÇÊ∫™,+8,24,16,60%,40,2023/03/21
540,1159,,Royal Annihilator,-1,66,47,58%,113,2023/04/13
541,1159,,Devos,-1,7,4,64%,11,2023/03/28
542,1159,,~SB ÁúüÂ§ö~,-4,27,18,60%,45,2023/04/07
543,1159,,miyanishi,+1,25,14,64%,39,2023/04/17
544,1159,,Elegant_Downfall,-1,8,4,67%,12,2023/03/28
545,1158,,RedLeaderToBase,-2,13,11,54%,24,2023/04/15
546,1158,,Sujy,+1,13,7,65%,20,2023/04/15
547,1158,,Iskra,-1,37,28,57%,65,2023/04/11
548,1158,,are,+1,108,78,58%,186,2023/03/29
549,1158,,AbangFadil,-1,132,114,54%,246,2023/04/17
550,1157,,Sticket,+1,21,20,51%,41,2023/04/14
551,1157,,acefromspace,-1,34,27,56%,61,2023/04/16
552,1157,,Gutsee,+2,15,7,68%,22,2023/03/24
553,1157,,Azusa,+4,86,75,53%,161,2023/04/16
554,1157,,Gnorri,+1,7,4,64%,11,2023/04/05
555,1157,,Joebill,+1,116,98,54%,214,2023/04/17
556,1157,,BarneyStinson,+1,150,116,56%,266,2023/04/17
557,1157,,Josef Ballin',+3,8,4,67%,12,2023/03/21
558,1157,,BALCK_9,-2,16,12,57%,28,2023/04/16
559,1156,,Ben,+1,19,16,54%,35,2023/04/15
560,1156,,XOM9lK,-1,25,16,61%,41,2023/04/12
561,1156,,offmask,-3,9,5,64%,14,2023/04/14
562,1155,,Zaney,+2,24,22,52%,46,2023/03/25
563,1155,,Kask,+5,13,6,68%,19,2023/03/28
564,1155,,Kos,+1,13,9,59%,22,2023/04/02
565,1154,,F4lcon,+1,125,107,54%,232,2023/04/17
566,1154,,dsrdhy9902,+1,12,10,55%,22,2023/04/17
567,1154,,ssume,+1,56,45,55%,101,2023/04/15
568,1153,,Joel,-1,23,16,59%,39,2023/04/17
569,1153,,T√≥√≥√≥r,+3,7,3,70%,10,2023/04/16
570,1153,,Haja,+4,8,3,73%,11,2023/04/17
571,1153,,Darth Jar Jar Binks,+2,34,23,60%,57,2023/04/03
572,1153,,EtherealDragon,+3,44,35,56%,79,2023/04/03
573,1153,,Hudini der Mann ohne Sound,-1,9,4,69%,13,2023/03/23
574,1152,,Parasite,+1,21,13,62%,34,2023/04/16
575,1152,,eybe,-1,10,6,63%,16,2023/04/08
576,1152,,SHVAKS,+1,24,16,60%,40,2023/03/29
577,1152,,12azzmatazz,+9,16,8,67%,24,2023/03/23
578,1151,,ad.,+7,14,7,67%,21,2023/03/29
579,1151,,RaBBBio^,+3,7,3,70%,10,2023/03/26
580,1151,,Scrufio,+2,11,6,65%,17,2023/03/25
581,1151,,Saevo,-1,18,11,62%,29,2023/04/05
582,1151,,J_Shizlet,+2,21,17,55%,38,2023/04/16
583,1150,,Nr03,-4,49,46,52%,95,2023/04/17
584,1150,,ÊÅ©ÊÅ©,+3,49,37,57%,86,2023/04/16
585,1150,,Lord Tachanka-savior,+2,45,36,56%,81,2023/04/15
586,1150,,OmnissiaH,-1,34,22,61%,56,2023/04/07
587,1150,,karamo6,-2,44,29,60%,73,2023/04/15
588,1150,,kizlo,+1,81,64,56%,145,2023/04/02
589,1150,,ÈîÖËøûÈïø,-4,95,79,55%,174,2023/04/17
590,1150,,Fish Ball,+2,8,5,62%,13,2023/03/24
591,1149,,Jello,-3,7,4,64%,11,2023/04/04
592,1149,,Esxile,+4,25,18,58%,43,2023/04/10
593,1149,,Pat Mustard,+3,8,4,67%,12,2023/04/07
594,1148,,REDACTED,-1,9,5,64%,14,2023/04/04
595,1147,,Window Shopping,+1,70,62,53%,132,2023/04/18
596,1147,,mickal21,+2,12,6,67%,18,2023/04/16
597,1147,,JJuKKuRi,-1,27,18,60%,45,2023/04/17
598,1147,,[TakTakTak]Boys,+2,19,16,54%,35,2023/03/31
599,1147,,SuperKeitel,-1,23,12,66%,35,2023/03/21
600,1146,,Dromaeda,-3,23,17,58%,40,2023/04/18
601,1146,,Off Meta,-3,300,245,55%,545,2023/04/17
602,1146,,Isnipeontwitch,-3,124,98,56%,222,2023/04/14
603,1146,,loovus,-1,9,5,64%,14,2023/03/21
604,1146,,Your Worst Nightmare,+1,26,22,54%,48,2023/04/10
605,1146,,Wulfe,-1,10,6,63%,16,2023/03/29
606,1145,,Patrick,+1,24,22,52%,46,2023/04/17
607,1145,,wardog,+2,11,7,61%,18,2023/04/09
608,1144,,lubi,-3,10,7,59%,17,2023/04/11
609,1143,,jc5776,+1,81,63,56%,144,2023/04/17
610,1143,,DarkAgeRush,-1,14,10,58%,24,2023/04/05
611,1143,,RepoRogue,-1,28,22,56%,50,2023/04/13
612,1143,,Capton X2,+2,57,40,59%,97,2023/04/13
613,1142,,DPdangi28,+3,23,15,61%,38,2023/04/12
614,1142,,ASWZ ScrotalLord,-2,28,19,60%,47,2023/04/02
615,1142,,Maup,+1,22,14,61%,36,2023/04/17
616,1142,,Diabulax,+1,15,11,58%,26,2023/03/26
617,1142,,Devrye,+2,14,7,67%,21,2023/03/28
618,1142,,Mr Indigo,-1,7,3,70%,10,2023/03/22
619,1141,,John 14,+2,19,12,61%,31,2023/04/08
620,1141,,Blizstolmnik,+3,8,6,57%,14,2023/04/10
621,1141,,BigGameHUnter,+2,80,63,56%,143,2023/04/17
622,1141,,Invokerka,-1,12,7,63%,19,2023/04/15
623,1140,,Nebel,+2,13,9,59%,22,2023/03/22
624,1140,,Unusualsoupcan,-2,35,28,56%,63,2023/03/31
625,1140,,B3rr3x,+1,50,36,58%,86,2023/04/14
626,1139,,KevinTDW,+5,22,17,56%,39,2023/04/06
627,1139,,[THT] Thusanai,-2,9,6,60%,15,2023/04/01
628,1139,,Der Regulator,-1,8,5,62%,13,2023/03/31
629,1139,,A fine rectal purge,+3,8,5,62%,13,2023/04/05
630,1138,,SmurfWolf,+1,28,23,55%,51,2023/04/17
631,1138,,NiW,+4,16,12,57%,28,2023/04/15
632,1138,,pokory,+1,12,6,67%,18,2023/04/16
633,1138,,LALO SALAMANCA,+3,10,6,63%,16,2023/04/17
634,1137,,StonedAssassin,+3,26,20,57%,46,2023/03/24
635,1137,,Mercury Blaze,-1,7,3,70%,10,2023/04/15
636,1137,,Eki2,-1,9,5,64%,14,2023/04/13
637,1137,,TheIceSage,+5,70,60,54%,130,2023/04/04
638,1136,,Tato,+3,41,32,56%,73,2023/04/16
639,1136,,phx.Mohikaner,-1,23,15,61%,38,2023/04/04
640,1136,,YouAreDead,+4,7,3,70%,10,2023/03/27
641,1135,,Speedbird,-1,174,134,56%,308,2023/04/17
642,1135,,403671774,-3,32,19,63%,51,2023/04/12
643,1134,,Superfula05,+1,20,14,59%,34,2023/04/02
644,1134,,medic,-1,11,6,65%,17,2023/04/15
645,1134,,KINDERPARTY,-3,77,64,55%,141,2023/04/03
646,1134,,Lethal,+1,31,26,54%,57,2023/04/15
647,1134,,BlaBla,+1,12,8,60%,20,2023/04/15
648,1134,,thecrazycowboygeneral,+3,198,174,53%,372,2023/04/18
649,1134,,Sleepy Gary,+1,19,13,59%,32,2023/03/24
650,1134,,Kannamix,+1,58,49,54%,107,2023/04/17
651,1133,,snekasan,+3,39,29,57%,68,2023/04/07
652,1133,,Ryniel,+4,30,22,58%,52,2023/04/12
653,1133,,Nobiscum Deus,+4,10,5,67%,15,2023/03/22
654,1133,,ÊÄªÁª¥Êñ∞,-2,12,10,55%,22,2023/04/17
655,1133,,ThanatosLT,+1,11,6,65%,17,2023/03/26
656,1133,,BiliBili ‰πÇ Á•ûÂ∏ïÊñØÁãº,-4,15,11,58%,26,2023/03/31
657,1133,,x_soldierOG,+2,24,17,59%,41,2023/03/28
658,1133,,Âè™ÊÑõ‚ù§ÊØõÂ¶π,+1,53,45,54%,98,2023/04/15
659,1132,,MrGrach,-3,28,24,54%,52,2023/04/04
660,1132,,suk,-2,60,38,61%,98,2023/04/17
661,1132,,Mystogan,-2,98,83,54%,181,2023/04/10
662,1132,,guazimodo,-1,76,68,53%,144,2023/04/04
663,1131,,Loncar,-1,17,9,65%,26,2023/04/17
664,1131,,Imaturkeith,-2,19,13,59%,32,2023/04/09
665,1131,,ZRL454,-1,11,8,58%,19,2023/04/14
666,1131,,PartTimeNinja,+2,19,15,56%,34,2023/04/11
667,1130,,Lord Heat,+2,7,4,64%,11,2023/03/30
668,1130,,Poodle,+1,40,35,53%,75,2023/04/16
669,1130,,Cain,+2,15,10,60%,25,2023/04/15
670,1130,,Maxi,+3,17,15,53%,32,2023/04/17
671,1130,,Dilophosaur,+1,15,9,63%,24,2023/04/05
672,1129,,D O M I N A T E,-2,20,16,56%,36,2023/04/10
673,1129,,Kiju,+3,15,11,58%,26,2023/04/07
674,1129,,VulcanHDGaming,-1,13,9,59%,22,2023/04/11
675,1129,,aleX „ÉÑ,+2,19,13,59%,32,2023/03/31
676,1129,,AdLibitum003,+4,7,4,64%,11,2023/04/03
677,1129,,Swol Team 6,-1,18,13,58%,31,2023/03/22
678,1129,,Free Stasiu,+1,10,7,59%,17,2023/04/03
679,1128,,alanlai9123,+4,7,4,64%,11,2023/04/16
680,1128,,BrutusHR,+1,8,6,57%,14,2023/03/23
681,1128,,TioFreak,+2,7,4,64%,11,2023/03/25
682,1128,,HI,-1,8,5,62%,13,2023/04/17
683,1127,,Keano,-1,16,9,64%,25,2023/03/25
684,1127,,Lillepus,+1,7,4,64%,11,2023/04/12
685,1127,,EËøû‚òÖÂ∑¶ÂÆóÊ£† ËÄÅÂπ¥ÁâπÊîªÈòü,+1,44,39,53%,83,2023/03/24
686,1127,,ALEJO5500,-1,90,72,56%,162,2023/04/02
687,1127,,Juvenile,+3,10,7,59%,17,2023/04/11
688,1126,,bukvi,-3,11,9,55%,20,2023/04/05
689,1126,,Sang-WOO! from SNU!,+1,21,19,53%,40,2023/04/12
690,1124,,Herodad,-1,17,14,55%,31,2023/04/01
691,1124,,Marcello,-2,6,4,60%,10,2023/04/14
692,1124,,TheGoodMoose,+1,10,5,67%,15,2023/04/17
693,1123,,mikeX,+3,15,8,65%,23,2023/04/12
694,1123,,SuppEngineer,+2,10,6,63%,16,2023/04/02
695,1123,,yunusG35,+1,34,27,56%,61,2023/04/17
696,1123,,BigLang,-3,28,17,62%,45,2023/04/09
697,1122,,BrainSplat | SoƒøŒõŒ†,+4,21,17,55%,38,2023/03/28
698,1122,,Stormthorn,+3,7,3,70%,10,2023/04/15
699,1122,,LPDAiborne82,+7,8,3,73%,11,2023/04/11
700,1122,,DiddlyHole,+4,13,7,65%,20,2023/04/17
701,1122,,C.G. Jung,-4,23,16,59%,39,2023/04/17
702,1122,,YouNeverKeepMeDown,-1,100,88,53%,188,2023/04/11
703,1122,,Euan,+3,22,16,58%,38,2023/03/31
704,1122,,Î∂àÍΩÉÎÇ®ÏûêÎ∞ïÏÉÅÏ§Ä,+2,34,25,58%,59,2023/04/16
705,1121,,cease2existt,-1,10,4,71%,14,2023/04/01
706,1121,,D3kay,+2,29,21,58%,50,2023/04/16
707,1121,,Clickar,-1,7,4,64%,11,2023/03/27
708,1121,,Nasredhin,-1,34,27,56%,61,2023/03/31
709,1121,,WARWOLFMELF,-1,17,12,59%,29,2023/03/22
710,1120,,LEV-Detahaven,+5,29,23,56%,52,2023/04/17
711,1120,,Cazasar,+4,7,3,70%,10,2023/03/24
712,1120,,JULIUS,-2,14,11,56%,25,2023/04/13
713,1120,,[IRS] EBass,+1,32,26,55%,58,2023/04/15
714,1119,,Sharpg,+2,15,12,56%,27,2023/04/06
715,1119,,Sinverguenza,-2,16,11,59%,27,2023/04/08
716,1119,,Yennefer of stalinberg,-1,8,4,67%,12,2023/04/07
717,1119,,shinjp,-1,65,59,52%,124,2023/03/21
718,1118,,inespie,+1,7,4,64%,11,2023/04/08
719,1118,,Apollo,-1,59,45,57%,104,2023/04/06
720,1118,,JJiGae,+2,41,31,57%,72,2023/04/16
721,1118,,James Baldwin,+1,26,19,58%,45,2023/04/08
722,1117,,Briefcase Taco,-2,19,17,53%,36,2023/04/15
723,1117,,krashbandicoot,-1,50,41,55%,91,2023/04/05
724,1116,,Willyto,+2,27,22,55%,49,2023/04/16
725,1116,,Grounded_Bagel,+1,45,38,54%,83,2023/04/07
726,1116,,BortekThePigeon,+3,10,7,59%,17,2023/04/02
727,1116,,WACA,-2,39,27,59%,66,2023/04/16
728,1116,,Wolfsindis,-1,9,7,56%,16,2023/04/03
729,1115,,MistaKupa,+3,9,6,60%,15,2023/04/11
730,1115,,2Fat2Furious,+1,101,102,50%,203,2023/04/09
731,1114,,GhOsT??? :),-1,7,4,64%,11,2023/04/13
732,1114,,ERIKB,-1,23,20,53%,43,2023/03/28
733,1114,,Bames Nond Having A Stronk,-1,16,12,57%,28,2023/04/17
734,1113,,Umbra Reloaded,+1,21,18,54%,39,2023/04/12
735,1113,,‚òÖ‚òÖ‚òÖJusaro‚òÖ‚òÖ‚òÖ,-1,32,24,57%,56,2023/04/11
736,1113,,Ashmole,+3,54,52,51%,106,2023/04/17
737,1113,,sarapowa,-2,51,39,57%,90,2023/04/11
738,1113,,Ondrejko,+1,27,24,53%,51,2023/04/15
739,1113,,Aliebuda,+7,13,8,62%,21,2023/04/14
740,1113,,Re4pR,-1,12,8,60%,20,2023/03/23
741,1112,,Lars,+2,8,4,67%,12,2023/04/07
742,1112,,GluteusMaximus,-1,10,6,63%,16,2023/04/17
743,1111,,Dr. Jungy Brungenn,+3,10,6,63%,16,2023/04/14
744,1111,,roelgoessen,+4,7,3,70%,10,2023/04/01
745,1111,,TetrisRanger,-1,28,19,60%,47,2023/03/29
746,1111,,Tango,+1,61,52,54%,113,2023/04/16
747,1111,,LaFaf,+1,18,16,53%,34,2023/03/31
748,1111,,7UziTotingMonkeys,+5,39,33,54%,72,2023/04/09
749,1111,,[DpS]Warlock,+1,6,4,60%,10,2023/04/06
750,1110,,Sostradayu,-1,50,47,52%,97,2023/04/14
751,1110,,Willaguy,-5,34,32,52%,66,2023/04/12
752,1110,,Rutherford B. Hayes,+1,15,12,56%,27,2023/03/31
753,1110,,Atisaurus,+1,6,4,60%,10,2023/04/12
754,1110,,Bel,+2,99,86,54%,185,2023/04/15
755,1109,,Xiaoxiao,-2,13,9,59%,22,2023/04/01
756,1109,,VV_Goth_VV,+3,10,5,67%,15,2023/03/22
757,1109,,rettep_s,+6,175,161,52%,336,2023/04/11
758,1109,,Hydroxylpentanol,+2,8,6,57%,14,2023/04/15
759,1109,,vCoh,+5,11,7,61%,18,2023/04/12
760,1108,,Doc,+1,14,10,58%,24,2023/04/06
761,1108,,TheGobbo,-1,16,12,57%,28,2023/04/17
762,1108,,Deepshine,-1,22,14,61%,36,2023/04/12
763,1108,,AoE rage,-1,12,8,60%,20,2023/03/30
764,1108,,Auxiliary Priest,+3,9,5,64%,14,2023/03/31
765,1108,,CHINESE DO NOT SPEAK ENGLISH,-1,6,4,60%,10,2023/04/03
766,1107,,Mr. Bepsi,+1,21,19,53%,40,2023/04/01
767,1107,,Pano_ramix,-2,20,14,59%,34,2023/04/14
768,1107,,Silence,+5,16,12,57%,28,2023/03/23
769,1106,,tangojuliett,+1,23,22,51%,45,2023/04/11
770,1106,,Nickoz,-2,15,14,52%,29,2023/04/09
771,1106,,firejay007,+5,12,7,63%,19,2023/04/17
772,1105,,GunGrave,+1,6,4,60%,10,2023/04/05
773,1105,,crizzy218,-4,13,9,59%,22,2023/04/10
774,1105,,Gn_Patton,-2,8,8,50%,16,2023/04/02
775,1105,,Donutrock,+1,6,4,60%,10,2023/04/08
776,1105,,Sergeant,+1,9,6,60%,15,2023/04/16
777,1105,,Corr,-2,10,8,56%,18,2023/04/01
778,1104,,—Ç–æ–≤–∞—Ä–∏—â LeiFeng,+3,7,5,58%,12,2023/04/17
779,1104,,wutface,+2,74,58,56%,132,2023/03/28
780,1104,,Finesse,+1,34,31,52%,65,2023/03/31
781,1104,,el deglingoo,-4,11,6,65%,17,2023/03/30
782,1104,,Auteeno_Manzano,+1,7,5,58%,12,2023/04/14
783,1104,,Hodolf,+3,25,17,60%,42,2023/04/13
784,1103,,Juggermarc,-1,8,4,67%,12,2023/04/15
785,1103,,Ê≤ÉËä¨ÁçÖ,+2,8,4,67%,12,2023/03/25
786,1103,,churchmf,+1,9,6,60%,15,2023/04/16
787,1103,,Grunka Lunka,-3,7,5,58%,12,2023/03/26
788,1103,,Hefe,+2,44,29,60%,73,2023/04/07
789,1103,,Junkz,-1,10,7,59%,17,2023/04/04
790,1102,,Logarr,-1,6,4,60%,10,2023/04/11
791,1102,,Bandit,+1,87,79,52%,166,2023/04/18
792,1101,,nolae,-2,6,5,55%,11,2023/03/21
793,1101,,Adonis Creed,-1,122,107,53%,229,2023/04/17
794,1101,,Vichunt_st,-1,18,13,58%,31,2023/04/17
795,1101,,Rolling9Deep,-2,6,4,60%,10,2023/03/30
796,1100,,Skyvendrake,-1,36,32,53%,68,2023/03/29
797,1100,,MoronPark-CPLASF,-1,6,4,60%,10,2023/04/11
798,1100,,Ranger1408,+1,28,24,54%,52,2023/04/16
799,1099,,PouK-ON #FrenchBanBan,+1,25,20,56%,45,2023/04/10
800,1099,,BloodSpark,+3,8,5,62%,13,2023/04/17
801,1099,,Dr. Malma,+2,32,23,58%,55,2023/03/27
802,1098,,Dance2Noel,+3,41,37,53%,78,2023/04/17
803,1098,,gkii1,-1,8,5,62%,13,2023/04/05
804,1098,,Karl123,-1,48,39,55%,87,2023/04/16
805,1098,,Boskever!?,+2,15,9,63%,24,2023/04/16
806,1098,,SkalliSol,+1,7,4,64%,11,2023/03/31
807,1098,,awayan,-1,32,20,62%,52,2023/03/30
808,1098,,Dvash,-3,11,10,52%,21,2023/04/14
809,1098,,Draj,-1,11,9,55%,20,2023/04/16
810,1098,,n0_ok,+2,23,21,52%,44,2023/04/05
811,1097,,Dred Furst,-2,7,6,54%,13,2023/04/15
812,1097,,J3WN1aL8T0R,-1,19,13,59%,32,2023/04/03
813,1097,,Cular13,+1,32,27,54%,59,2023/04/17
814,1097,,:o its terrA!,+6,8,5,62%,13,2023/04/16
815,1097,,Âè™Âõ†‰Ω†Â§™Áæé,+1,18,14,56%,32,2023/04/11
816,1097,,Chemicals,+3,82,71,54%,153,2023/04/07
817,1097,,Octavius Rex,+3,14,11,56%,25,2023/04/12
818,1097,,APM50,+1,6,4,60%,10,2023/03/21
819,1096,,‚â°[EZGK]‚â° T3dgO13,+2,10,5,67%,15,2023/04/17
820,1096,,acn322,-1,117,94,55%,211,2023/04/18
821,1096,,77Row,+1,10,8,56%,18,2023/04/16
822,1096,,Enlightened Enlisted,+2,33,24,58%,57,2023/03/23
823,1096,,HAN-[cw]100980315,-1,17,12,59%,29,2023/04/11
824,1095,,jinkmoon2,+4,33,27,55%,60,2023/04/15
825,1095,,MoRaCe,-1,13,12,52%,25,2023/03/26
826,1095,,LotDExile,-2,22,17,56%,39,2023/04/09
827,1095,,Relo4d,-2,6,4,60%,10,2023/04/17
828,1095,,Ë∂ÖÁ∫ßÊ∞üÂà©ÊòÇ,-3,54,48,53%,102,2023/04/16
829,1095,,Vanilla Ice,+1,12,8,60%,20,2023/03/22
830,1094,,Leninade,+1,8,6,57%,14,2023/04/08
831,1094,,Basilone,-3,43,38,53%,81,2023/04/08
832,1094,,R4md4c,-1,12,12,50%,24,2023/03/31
833,1094,,SHM-xXbaselXx-PaL,+1,11,12,48%,23,2023/04/09
834,1094,,rodfileto,+3,11,8,58%,19,2023/04/07
835,1094,,Kartze,+2,8,5,62%,13,2023/03/21
836,1094,,vuko_zrno,-2,12,13,48%,25,2023/04/05
837,1093,,Madsness,-1,8,5,62%,13,2023/04/08
838,1093,,Vitzy J,+1,10,5,67%,15,2023/03/30
839,1093,,Sea raider,-3,27,21,56%,48,2023/03/28
840,1093,,mooxoxo,+1,45,40,53%,85,2023/04/15
841,1093,,Shockz,-3,27,24,53%,51,2023/04/17
842,1093,,marcmorn,+1,32,31,51%,63,2023/04/15
843,1092,,Everstorm,-2,7,6,54%,13,2023/03/28
844,1092,,nazibbq,-2,7,6,54%,13,2023/04/08
845,1092,,Studano,+3,15,9,63%,24,2023/04/11
846,1092,,Q.man,-4,22,20,52%,42,2023/04/16
847,1092,,KG_Kostov,-4,22,18,55%,40,2023/03/25
848,1091,,88jpmm,+1,76,68,53%,144,2023/04/17
849,1091,,ÊàëË¶ÅÂêëÂÖ¨ÂÆâ‰∏æÊä•‰Ω†,-2,17,15,53%,32,2023/04/05
850,1091,,WeLoveFinals,-2,22,21,51%,43,2023/03/28
851,1091,,Patrick,+2,13,10,57%,23,2023/04/10
852,1091,,Skreddern,-2,28,24,54%,52,2023/03/31
853,1091,,DPJ_realy,-2,22,18,55%,40,2023/04/09
854,1091,,All Day,+1,18,16,53%,34,2023/04/17
855,1091,,sebeck,+4,25,17,60%,42,2023/04/17
856,1091,,Aparoid96,-1,83,68,55%,151,2023/04/16
857,1091,,tsikau,-4,8,8,50%,16,2023/03/22
858,1090,,Mike,+1,17,16,52%,33,2023/04/17
859,1090,,Sporange87,-2,35,28,56%,63,2023/04/17
860,1090,,Libre,+1,10,8,56%,18,2023/04/16
861,1090,,ADOLFO_CABRERA,-1,25,18,58%,43,2023/04/05
862,1089,,WhatTheHelms,+1,9,8,53%,17,2023/03/24
863,1089,,Baked Potato,-2,12,9,57%,21,2023/04/01
864,1088,,Ekko Tek,+2,6,4,60%,10,2023/03/25
865,1088,,50ping,+1,6,4,60%,10,2023/04/02
866,1088,,EffUrDayUp,+1,6,4,60%,10,2023/03/26
867,1087,,G√∂BL√ÜN,+3,23,19,55%,42,2023/04/07
868,1087,,Sevas,-3,36,36,50%,72,2023/04/14
869,1087,,Indyjunk,-1,6,4,60%,10,2023/03/25
870,1087,,error 404 player not found,+2,7,4,64%,11,2023/03/22
871,1087,,SovietBuffalo,+1,14,10,58%,24,2023/04/16
872,1087,,Vayze,-1,6,5,55%,11,2023/04/08
873,1087,,Sundman,-2,15,12,56%,27,2023/04/11
874,1087,,sormi,+2,9,6,60%,15,2023/03/28
875,1087,,leonmp4797559,-1,186,184,50%,370,2023/04/17
876,1086,,shekelxpress,+4,66,56,54%,122,2023/04/15
877,1086,,POUP,+1,12,8,60%,20,2023/04/11
878,1086,,riccoriccosupershaker,+5,38,33,54%,71,2023/04/17
879,1085,,‚òÖColonel-zuvyna‚òÖ,-1,17,12,59%,29,2023/04/04
880,1085,,PlammX,+2,8,5,62%,13,2023/04/06
881,1085,,Dennieh,-4,5,5,50%,10,2023/04/03
882,1085,,natolaeger,-1,16,11,59%,27,2023/04/07
883,1085,,Dad,-3,10,10,50%,20,2023/03/21
884,1085,,Ventus,-2,118,101,54%,219,2023/04/01
885,1084,,Damacles,+1,8,6,57%,14,2023/04/02
886,1084,,xJCx fallen,+1,7,5,58%,12,2023/04/03
887,1084,,Armadin,+3,21,21,50%,42,2023/04/09
888,1084,,IntegralMagno,-2,15,12,56%,27,2023/03/25
889,1084,,dr_squid,+2,16,11,59%,27,2023/03/28
890,1084,,A N U S,+3,8,4,67%,12,2023/04/15
891,1083,,Mentat,+1,35,26,57%,61,2023/04/17
892,1083,,holy handgrenade,-2,6,5,55%,11,2023/04/02
893,1083,,‰πîÈæôËø™ÂÖã,-2,9,7,56%,16,2023/04/01
894,1083,,ralneck52,-1,6,5,55%,11,2023/03/21
895,1083,,Alex_the_kid,+6,18,10,64%,28,2023/04/01
896,1083,,ÁÜ¨Â§ú‰ºöÁßÉÂ§¥,-2,35,33,51%,68,2023/04/03
897,1082,,warblewarblewarble,-1,93,80,54%,173,2023/04/17
898,1082,,Â§üÂæóÂà∞ÁöÑÈíüÊëÜ,-3,18,17,51%,35,2023/04/01
899,1082,,DrDoom,+1,36,32,53%,68,2023/04/02
900,1082,,#No_brain,-1,6,4,60%,10,2023/04/01
901,1082,,max,+1,15,10,60%,25,2023/03/21
902,1082,,Bears Beets,-1,66,56,54%,122,2023/04/17
903,1082,,zyk1999,-3,13,11,54%,24,2023/03/27
904,1081,,porta_house_steak,-1,38,31,55%,69,2023/03/22
905,1081,,Á±≥Âãí‰∏äÂ∞â‚òÖJohn millers.us,+2,75,69,52%,144,2023/04/17
906,1081,,Phillip II - Wardaddy,-1,10,8,56%,18,2023/04/16
907,1081,,Pero,+1,33,30,52%,63,2023/04/10
908,1081,,maker,+2,97,84,54%,181,2023/04/13
909,1081,,Testicular Chewing Goat,-2,7,4,64%,11,2023/04/13
910,1080,,dog,+2,64,55,54%,119,2023/04/17
911,1080,,Mr.Drix,-5,13,11,54%,24,2023/03/21
912,1080,,bluegreen,-2,17,16,52%,33,2023/04/06
913,1080,,Steiner,-2,11,7,61%,18,2023/04/04
914,1080,,198964,+5,21,17,55%,38,2023/04/05
915,1079,,kennyemmy,+2,6,4,60%,10,2023/03/30
916,1079,,J√ºnker,+1,6,4,60%,10,2023/04/12
917,1079,,Psychomantis.PANG,-2,8,5,62%,13,2023/04/16
918,1079,,Segruba,-2,11,11,50%,22,2023/04/05
919,1079,,AllFillaNoScrilla,+3,9,7,56%,16,2023/04/08
920,1079,,Bilu,-4,72,58,55%,130,2023/04/17
921,1079,,Stronk snulk,-1,14,11,56%,25,2023/04/08
922,1079,,Meepic,-3,13,14,48%,27,2023/04/07
923,1078,,Champion,+1,12,9,57%,21,2023/03/23
924,1078,,Ryxon,+4,9,6,60%,15,2023/04/12
925,1078,,dolph,+1,6,4,60%,10,2023/04/06
926,1078,,Core,-3,9,9,50%,18,2023/04/14
927,1078,,Shraken,-2,9,7,56%,16,2023/03/30
928,1078,,Rocky,+3,14,13,52%,27,2023/03/28
929,1078,,I am not chinese,+1,27,23,54%,50,2023/04/01
930,1078,,Lil Crit,+3,28,24,54%,52,2023/04/08
931,1078,,„Éâ„É´„Éº„ÇÆ„Éº,-1,10,7,59%,17,2023/03/29
932,1078,,xuliang16879,+1,66,62,52%,128,2023/03/31
933,1078,,Zuntew...,+2,14,10,58%,24,2023/04/16
934,1077,,dbsights,+1,15,13,54%,28,2023/03/31
935,1077,,GeiloGerald,+2,9,6,60%,15,2023/04/10
936,1077,,StarSoulZ,-1,72,65,53%,137,2023/04/13
937,1077,,Aqri,-3,24,20,55%,44,2023/04/06
938,1077,,Temujai,+2,13,12,52%,25,2023/03/23
939,1077,,leo881202,+1,16,14,53%,30,2023/04/13
940,1076,,Sentinel pls,-2,18,19,49%,37,2023/04/17
941,1076,,KC,-1,8,6,57%,14,2023/04/17
942,1076,,Rocky0730,-4,17,17,50%,34,2023/04/06
943,1076,,‚ú†‚Ñú‚Ñå‚Ñ≠i‚Ñµ‚ú†‚Ñ≥‚Ñ≠‚ò¶ŒîLL,+1,6,4,60%,10,2023/04/16
944,1075,,Echo,+5,31,33,48%,64,2023/04/16
945,1075,,NeuralBooch,+1,11,11,50%,22,2023/04/15
946,1075,,Jayu,-1,6,4,60%,10,2023/03/21
947,1075,,‡πñ€£€úF1re,-1,27,20,57%,47,2023/04/11
948,1075,,Freydal,-4,56,47,54%,103,2023/04/16
949,1074,,571803985,+2,8,5,62%,13,2023/04/17
950,1074,,junkmail,+1,57,59,49%,116,2023/04/14
951,1074,,Vettlen,+1,9,8,53%,17,2023/04/17
952,1074,,Jango,+1,29,27,52%,56,2023/04/13
953,1073,,Thesin,+1,6,4,60%,10,2023/03/29
954,1073,,Chu,+3,8,6,57%,14,2023/04/16
955,1073,,Patchouli Knowledge,-2,16,13,55%,29,2023/04/01
956,1073,,Ê≠£‰πâÂÖÑÂ§ßÂü∫,-2,11,9,55%,20,2023/03/21
957,1073,,large boss,-1,19,14,58%,33,2023/04/01
958,1072,,Pedro Jedi,-3,25,21,54%,46,2023/04/01
959,1072,,r.e.d.d.e.v.i.l,+1,11,9,55%,20,2023/04/08
960,1072,,AlphaOmega,-2,21,15,58%,36,2023/04/04
961,1072,,Hakunamatada187,+3,10,7,59%,17,2023/03/24
962,1072,,8ug8ear,-1,32,28,53%,60,2023/04/17
963,1072,,Le rat Madan,+1,8,6,57%,14,2023/04/11
964,1072,,neelkoos,-1,25,20,56%,45,2023/04/16
965,1072,,er1k,-1,9,6,60%,15,2023/04/17
966,1072,,rapideyemovement,-2,15,13,54%,28,2023/04/16
967,1072,,Stanley_IceMan_PL,-2,35,29,55%,64,2023/04/02
968,1072,,Divine Fury,+4,46,42,52%,88,2023/04/17
969,1071,,RNGesus,-2,36,33,52%,69,2023/04/17
970,1071,,DaReDeViL,+2,24,19,56%,43,2023/04/12
971,1071,,Witcher,+1,8,6,57%,14,2023/04/09
972,1071,,Ding Dong,-3,46,44,51%,90,2023/04/16
973,1071,,VonLinden,-2,23,25,48%,48,2023/04/17
974,1070,,WazzaBozza,-3,7,6,54%,13,2023/04/06
975,1070,,‚ú° Merchant ‚ú°,+1,13,12,52%,25,2023/04/07
976,1070,,nobodycan137,+1,11,8,58%,19,2023/04/05
977,1068,,EchoOne,+3,21,14,60%,35,2023/03/28
978,1068,,Yeknod,+2,104,126,45%,230,2023/04/16
979,1068,,General Feldsalat,-2,62,52,54%,114,2023/03/28
980,1068,,Endless Pera,-2,15,14,52%,29,2023/04/07
981,1067,,Gunny,+2,6,4,60%,10,2023/04/04
982,1067,,Rifllian,+6,7,4,64%,11,2023/04/06
983,1067,,Burnt Toast,-1,12,7,63%,19,2023/04/15
984,1066,,Breeze,+1,19,17,53%,36,2023/04/08
985,1066,,kingdom15,-1,6,6,50%,12,2023/03/24
986,1066,,Niko,+1,20,18,53%,38,2023/03/31
987,1065,,Cipher,+2,6,4,60%,10,2023/04/08
988,1065,,APGCobra,+1,7,7,50%,14,2023/03/26
989,1065,,BA_Flesh_WounD,-5,15,14,52%,29,2023/04/14
990,1065,,chiuchiu63333,+2,34,25,58%,59,2023/04/17
991,1065,,HeroicBillyBishop,+4,39,31,56%,70,2023/03/27
992,1065,,NightGoDt,-2,54,49,52%,103,2023/04/17
993,1065,,Rezkin-Gurh,-2,12,8,60%,20,2023/03/24
994,1064,,iswtiger,+3,15,11,58%,26,2023/04/17
995,1064,,The Mega,-1,136,136,50%,272,2023/04/17
996,1064,,proton88,-2,6,4,60%,10,2023/03/24
997,1064,,KingSeamus,+2,26,22,54%,48,2023/03/30
998,1064,,//hd_389,+3,46,46,50%,92,2023/04/16
999,1064,,barti06,-4,152,125,55%,277,2023/04/01
1000,1064,,Clownslayer,-2,14,12,54%,26,2023/04/17
1001,1063,,OverlordCZ,-1,158,155,50%,313,2023/04/16
1002,1063,,Rebel Gizmo,-1,35,34,51%,69,2023/04/10
1003,1063,,Ladabaz,+1,28,20,58%,48,2023/04/09
1004,1063,,Exodiac,-2,15,11,58%,26,2023/04/12
1005,1063,,Âë®Â≠êÈπ§,+2,34,33,51%,67,2023/03/22
1006,1063,,keke,+4,6,4,60%,10,2023/04/15
1007,1063,,SoloWingPixy,-2,12,12,50%,24,2023/03/24
1008,1062,,KernalWolf,-2,19,18,51%,37,2023/04/04
1009,1062,,Lemon and Apples,-2,26,21,55%,47,2023/04/09
1010,1062,,JRocinante,-1,8,7,53%,15,2023/04/13
1011,1062,,Hekezu,-6,36,33,52%,69,2023/04/09
1012,1062,,Micro,+1,117,113,51%,230,2023/04/17
1013,1062,,hollywood,+1,150,139,52%,289,2023/03/29
1014,1062,,Solver,+5,71,69,51%,140,2023/04/12
1015,1061,,Haxses,+2,7,5,58%,12,2023/03/23
1016,1061,,Alexem,+4,53,48,52%,101,2023/04/16
1017,1061,,sergiexp,+1,53,53,50%,106,2023/04/17
1018,1061,,spitfireheat,-2,10,8,56%,18,2023/04/14
1019,1061,,Nemo,+1,46,38,55%,84,2023/04/16
1020,1061,,ThreeOracle,-2,7,5,58%,12,2023/04/09
1021,1061,,Invicta,-3,11,11,50%,22,2023/04/14
1022,1061,,Autobahn Bisquick,+1,64,61,51%,125,2023/04/07
1023,1061,,Haag,-1,8,6,57%,14,2023/03/23
1024,1061,,Waffles,-1,10,8,56%,18,2023/04/12
1025,1060,,PotatoPleb,+2,22,19,54%,41,2023/03/26
1026,1060,,Random,+1,12,10,55%,22,2023/04/08
1027,1060,,TheVVitcher,-1,6,4,60%,10,2023/03/21
1028,1060,,Morlezan,+1,50,61,45%,111,2023/04/17
1029,1060,,Cpt. Unicorn,+1,12,11,52%,23,2023/04/10
1030,1060,,WeakTendon,-2,8,8,50%,16,2023/04/14
1031,1060,,Bacaphonic,-1,8,7,53%,15,2023/04/04
1032,1059,,Goonmoo,+2,9,7,56%,16,2023/03/25
1033,1059,,Al Broken Capote,+2,12,9,57%,21,2023/03/25
1034,1059,,jordanglez97,-1,51,49,51%,100,2023/04/17
1035,1059,,GelbeBanane,+1,6,4,60%,10,2023/04/03
1036,1059,,sebaschaos,-3,34,33,51%,67,2023/03/28
1037,1058,,Eternal_Dawn,-1,90,84,52%,174,2023/04/17
1038,1057,,Khorne's Penguin,-3,40,33,55%,73,2023/04/01
1039,1057,,KampfLachs,+2,14,12,54%,26,2023/04/15
1040,1057,,Brightsite,+2,17,15,53%,32,2023/04/16
1041,1057,,lappodamy,+4,30,22,58%,52,2023/04/17
1042,1056,,Legion707,-2,19,18,51%,37,2023/03/29
1043,1056,,JJs Juggernaut,-3,16,13,55%,29,2023/03/31
1044,1055,,Private_Schneewittchen,-1,7,5,58%,12,2023/03/22
1045,1055,,archie,+2,53,50,51%,103,2023/04/13
1046,1055,,XcomReborn,-1,6,5,55%,11,2023/03/29
1047,1054,,PG88,+2,6,5,55%,11,2023/04/07
1048,1054,,Antagonist,+2,48,41,54%,89,2023/04/11
1049,1054,,sitrock,-1,19,13,59%,32,2023/04/08
1050,1054,,Neuromancer,+1,9,8,53%,17,2023/04/15
1051,1054,,Scotty!,+2,37,34,52%,71,2023/04/10
1052,1053,,RRREEEIII,-4,26,28,48%,54,2023/04/08
1053,1053,,de_prodigz,+2,37,31,54%,68,2023/04/14
1054,1053,,SmittyWicked,+1,10,10,50%,20,2023/03/29
1055,1053,,TankFodder,+2,10,8,56%,18,2023/03/25
1056,1053,,Dharx,-1,9,8,53%,17,2023/04/01
1057,1053,,Pille,+2,25,20,56%,45,2023/04/16
1058,1053,,MrKaos,+1,35,33,51%,68,2023/04/11
1059,1052,,abenco00,+4,21,19,53%,40,2023/04/09
1060,1052,,Giuseppe,-1,20,16,56%,36,2023/03/24
1061,1052,,Lergen,-4,14,13,52%,27,2023/04/11
1062,1052,,noluckystrike,-4,9,9,50%,18,2023/04/10
1063,1052,,NorthWeapon,-2,15,12,56%,27,2023/03/28
1064,1052,,Narcommando,-2,10,9,53%,19,2023/04/10
1065,1051,,SniperKeo,-1,6,5,55%,11,2023/04/03
1066,1051,,FitzBro,+2,27,22,55%,49,2023/03/31
1067,1051,,Not Krizzo,+2,9,7,56%,16,2023/03/22
1068,1051,,take0again,+1,9,7,56%,16,2023/04/01
1069,1051,,Slug,+1,17,14,55%,31,2023/04/07
1070,1051,,Fabz,+1,21,20,51%,41,2023/04/06
1071,1050,,Timsky,-5,5,6,45%,11,2023/04/10
1072,1050,,Boss Of This Gym,+1,46,43,52%,89,2023/04/09
1073,1050,,Croaker,+1,9,8,53%,17,2023/03/25
1074,1049,,Booglog,-1,17,13,57%,30,2023/03/21
1075,1049,,FreeWilly,+1,7,7,50%,14,2023/03/27
1076,1049,,YzY,+1,6,4,60%,10,2023/04/15
1077,1048,,Nismo,+2,122,109,53%,231,2023/04/17
1078,1048,,EricArtanis,+6,12,9,57%,21,2023/03/21
1079,1048,,Halophile,-2,6,4,60%,10,2023/03/23
1080,1048,,Killhold,-1,12,10,55%,22,2023/03/21
1081,1048,,Louis_XJ,+1,18,16,53%,34,2023/04/17
1082,1047,,Hipoapa,+3,11,8,58%,19,2023/04/08
1083,1047,,TJsOnOmega,-4,80,76,51%,156,2023/03/26
1084,1047,,spz,-1,15,10,60%,25,2023/04/15
1085,1047,,Brick-A-ttack,-1,8,5,62%,13,2023/04/05
1086,1047,,Mike,-2,20,17,54%,37,2023/04/17
1087,1046,,Rhendycash,+1,7,6,54%,13,2023/03/26
1088,1046,,Equeslibertatis,+1,11,9,55%,20,2023/03/27
1089,1046,,WayTooTicklish,+1,11,12,48%,23,2023/03/26
1090,1045,,'sWiNgEz,+1,11,11,50%,22,2023/04/12
1091,1045,,Kirov,-1,30,29,51%,59,2023/04/10
1092,1045,,steakiller,-4,8,7,53%,15,2023/04/10
1093,1045,,Hagga,+1,35,32,52%,67,2023/04/17
1094,1045,,JorgitisPR,-1,43,46,48%,89,2023/04/17
1095,1045,,Ja Sam Tvoj Bog,+3,13,11,54%,24,2023/04/18
1096,1045,,Ultron,+7,69,71,49%,140,2023/04/17
1097,1045,,Alwaroski,+5,7,5,58%,12,2023/03/28
1098,1045,,Povke,+2,6,4,60%,10,2023/04/13
1099,1045,,obbzipobbzi,+2,9,8,53%,17,2023/04/06
1100,1045,,–®–æ–±–ª–∞–π–æ–±–ª–∞,-3,6,6,50%,12,2023/04/13
1101,1044,,moletsplui,+1,9,7,56%,16,2023/04/13
1102,1044,,Le Negev,-3,7,7,50%,14,2023/03/21
1103,1044,,Ahora Comprendo,+1,8,8,50%,16,2023/03/31
1104,1044,,Strikeforce,+4,19,18,51%,37,2023/04/08
1105,1044,,rarehunter_dark,+1,9,8,53%,17,2023/04/11
1106,1044,,unicoevo,-3,13,14,48%,27,2023/04/05
1107,1044,,Uncle Moist,+2,8,7,53%,15,2023/03/25
1108,1044,,symbolsix,+1,11,10,52%,21,2023/04/17
1109,1044,,PangBUBBA,-2,16,14,53%,30,2023/03/30
1110,1043,,xGSx Gladiator,+2,33,36,48%,69,2023/04/17
1111,1043,,TheZiplon,-3,85,76,53%,161,2023/04/17
1112,1043,,DarthPotato,-1,7,7,50%,14,2023/04/16
1113,1043,,Fotyn,+3,16,16,50%,32,2023/04/14
1114,1043,,Marcellus82,-2,10,10,50%,20,2023/03/30
1115,1042,,ETALYCS,-3,5,5,50%,10,2023/04/10
1116,1042,,GKarsa,-1,65,58,53%,123,2023/04/16
1117,1042,,kdguno,+1,24,22,52%,46,2023/04/08
1118,1042,,demenza058,+2,8,6,57%,14,2023/04/05
1119,1042,,Sojourner,+1,14,16,47%,30,2023/04/07
1120,1042,,Waltzing Matilda,-5,48,44,52%,92,2023/04/16
1121,1042,,MichaelOyster,-5,42,36,54%,78,2023/04/09
1122,1042,,Tersy,-1,8,6,57%,14,2023/04/08
1123,1041,,PandaWarrior,-2,168,165,50%,333,2023/04/17
1124,1041,,Walkerthon,+2,18,17,51%,35,2023/04/08
1125,1041,,Compulsion,+1,26,24,52%,50,2023/04/17
1126,1041,,wayne7535357,+1,6,5,55%,11,2023/04/09
1127,1041,,POWERTOM,-4,9,10,47%,19,2023/04/15
1128,1041,,ÈÉÅÈáëÈ¶ôÂì™Êúâ‰Ω†ÁöÑÊµ¥Â∑æÈ¶ô,-1,8,7,53%,15,2023/04/14
1129,1040,,BL4CKBuBBLe,-3,63,64,50%,127,2023/04/17
1130,1040,,Mr. Infamous,-2,9,8,53%,17,2023/04/04
1131,1040,,Kronkers,+2,9,8,53%,17,2023/04/15
1132,1040,,chris,-1,8,7,53%,15,2023/03/28
1133,1039,,Trissse,-1,5,6,45%,11,2023/04/06
1134,1039,,go2103498,-2,9,7,56%,16,2023/04/14
1135,1039,,Joker239,+2,7,5,58%,12,2023/03/30
1136,1039,,DAJUAN,-1,135,129,51%,264,2023/04/17
1137,1039,,Ibex,+1,42,36,54%,78,2023/04/11
1138,1039,,sVad,+4,9,7,56%,16,2023/04/05
1139,1038,,FriedRavioli,+1,5,5,50%,10,2023/04/06
1140,1038,,Columbus,-2,6,5,55%,11,2023/04/11
1141,1038,,e s 0,-1,31,30,51%,61,2023/04/10
1142,1038,,pokkerguy,-3,5,5,50%,10,2023/04/14
1143,1038,,LiffLaffLuff,+4,9,7,56%,16,2023/04/16
1144,1038,,beef,+1,5,5,50%,10,2023/04/09
1145,1037,,Back3r,-1,10,11,48%,21,2023/03/25
1146,1037,,ToYson,+1,7,5,58%,12,2023/03/24
1147,1037,,qwbvvvvV,-4,11,12,48%,23,2023/04/17
1148,1037,,MTN_Bergzwerg,+1,8,8,50%,16,2023/03/22
1149,1037,,Asrach,-3,40,37,52%,77,2023/04/07
1150,1037,,Dur3X,-2,11,11,50%,22,2023/04/08
1151,1037,,ÍπÄÏπò ÎèÑÍπ®ÎπÑ,+3,11,8,58%,19,2023/03/23
1152,1036,,Savannah,-1,68,60,53%,128,2023/04/12
1153,1036,,Commissar,-5,11,13,46%,24,2023/04/16
1154,1036,,Casper,+5,52,52,50%,104,2023/04/17
1155,1036,,EVILUTION,+3,9,7,56%,16,2023/04/15
1156,1036,,TheMonkeyInChargeOfBananas,-5,15,15,50%,30,2023/04/07
1157,1036,,Pato de Asalto,+3,23,21,52%,44,2023/04/16
1158,1036,,Nil,-1,6,4,60%,10,2023/04/02
1159,1036,,18Â≤ÅÁî∑Â§ßÂ≠¶Áîü‰∏ç‰ºöÊåÇÁßë,+3,15,12,56%,27,2023/03/29
1160,1035,,SzarywilkPL,-1,9,8,53%,17,2023/03/25
1161,1035,,Stemonitis,-5,58,54,52%,112,2023/04/17
1162,1035,,Foxinko,-2,10,10,50%,20,2023/04/12
1163,1035,,Thoralf,+2,8,8,50%,16,2023/04/01
1164,1035,,Black Chailley,-1,19,17,53%,36,2023/03/25
1165,1035,,zzqhax,+1,10,8,56%,18,2023/04/17
1166,1034,,StyX,-1,10,8,56%,18,2023/04/10
1167,1034,,RunningWithFate,+2,14,11,56%,25,2023/03/25
1168,1034,,subzero_86,-1,7,6,54%,13,2023/03/22
1169,1034,,CrazyGuy,-3,13,14,48%,27,2023/03/30
1170,1034,,Envisionaried,+1,7,6,54%,13,2023/03/25
1171,1034,,CPU-Easy,-8,19,20,49%,39,2023/03/29
1172,1033,,Demolidor,+1,43,41,51%,84,2023/04/09
1173,1033,,Samp,-3,57,56,50%,113,2023/04/17
1174,1033,,mikec_81,+1,9,10,47%,19,2023/04/17
1175,1033,,IntKennen,+2,37,30,55%,67,2023/04/03
1176,1033,,ohlsson,-1,14,14,50%,28,2023/04/15
1177,1033,,Boosh,-3,6,6,50%,12,2023/03/26
1178,1032,,Kaiser Soze,+1,25,24,51%,49,2023/04/15
1179,1032,,Emspan,-4,5,5,50%,10,2023/04/07
1180,1032,,ËøôÊòØÁúüÁöÑÂêó,-5,17,14,55%,31,2023/04/06
1181,1032,,SaltyCake,+1,8,6,57%,14,2023/04/15
1182,1031,,Bouda,+4,12,10,55%,22,2023/04/15
1183,1031,,[MetneM].Miljan,-1,6,5,55%,11,2023/04/09
1184,1030,,Darman,-2,30,29,51%,59,2023/04/18
1185,1030,,CZECH /1st. Division,+1,6,5,55%,11,2023/04/03
1186,1030,,LeMazzarin,+2,5,5,50%,10,2023/04/08
1187,1030,,K√∂ttbulleKungen,+1,6,5,55%,11,2023/04/04
1188,1030,,willc000,+1,58,58,50%,116,2023/04/18
1189,1030,,Olybrius,-2,6,5,55%,11,2023/03/28
1190,1030,,"Useless, Laggy Player",-1,8,10,44%,18,2023/04/12
1191,1030,,[WD44]Tassadar,-1,10,9,53%,19,2023/04/17
1192,1029,,Bland Unicorn,-1,38,31,55%,69,2023/04/09
1193,1029,,Sharklebois,+1,54,49,52%,103,2023/04/17
1194,1029,,Mr.Anthoyl,-1,6,6,50%,12,2023/03/29
1195,1029,,COH3SVP,-2,5,5,50%,10,2023/04/02
1196,1029,,MacP,-4,12,14,46%,26,2023/04/16
1197,1028,,Eddie Spaghetti,-2,5,5,50%,10,2023/04/17
1198,1028,,L. Vorenus,-1,15,12,56%,27,2023/04/16
1199,1028,,C.R.E.A.M,+1,13,14,48%,27,2023/04/12
1200,1028,,SHALDUN,+1,11,8,58%,19,2023/03/26
1201,1028,,Ferdi,-1,7,6,54%,13,2023/04/13
1202,1028,,M:P:5,-3,21,20,51%,41,2023/03/29
1203,1028,,Gonvalen,-2,69,60,53%,129,2023/04/12
1204,1027,,new6oot9oofin,-2,27,27,50%,54,2023/04/02
1205,1027,,{Eliote Le Pilote},+5,20,20,50%,40,2023/04/10
1206,1027,,BSG,-4,24,27,47%,51,2023/04/17
1207,1027,,HUARD [fr],-1,10,9,53%,19,2023/04/06
1208,1027,,Buschwookie Burnhard,-2,5,5,50%,10,2023/04/03
1209,1026,,BeniSev,+1,13,11,54%,24,2023/04/16
1210,1026,,Filthy Peasant,-5,51,48,52%,99,2023/04/16
1211,1026,,burble5,-2,20,17,54%,37,2023/04/06
1212,1026,,tkaqkdlsdud,-1,20,16,56%,36,2023/04/14
1213,1026,,üèπt»üogkt√©kAüî™üíÄü™ì,-2,26,32,45%,58,2023/04/07
1214,1026,,Los ewok,-1,16,15,52%,31,2023/04/14
1215,1025,,Supersonic_86,-3,17,14,55%,31,2023/04/04
1216,1025,,NormalDude69,+5,12,12,50%,24,2023/04/09
1217,1025,,GrIMM,+1,12,16,43%,28,2023/03/22
1218,1025,,Chucleskill,-1,51,45,53%,96,2023/04/10
1219,1024,,ironicusername17,+2,44,39,53%,83,2023/04/17
1220,1024,,Hooked,-3,5,5,50%,10,2023/03/25
1221,1024,,DanRegi,+2,31,32,49%,63,2023/04/15
1222,1023,,MYaHa,+1,7,6,54%,13,2023/04/14
1223,1023,,PaiN,+1,28,27,51%,55,2023/03/23
1224,1023,,Shivara,-2,6,6,50%,12,2023/03/28
1225,1023,,Melonplant,-5,5,5,50%,10,2023/04/17
1226,1023,,drunken JEFFERY thug,-1,57,57,50%,114,2023/04/03
1227,1023,,Elphiroce,-1,5,5,50%,10,2023/04/06
1228,1023,,Thomas,+1,7,7,50%,14,2023/04/16
1229,1023,,Danger,-2,5,5,50%,10,2023/03/26
1230,1022,,Trenton,-2,6,7,46%,13,2023/03/25
1231,1022,,asteelec,+2,42,41,51%,83,2023/04/11
1232,1022,,Karim,-2,8,8,50%,16,2023/03/21
1233,1022,,ryuklikesapples,+1,30,29,51%,59,2023/04/09
1234,1022,,Unfortunate Son,+2,22,19,54%,41,2023/04/02
1235,1022,,Cpt.Ray,+1,10,10,50%,20,2023/03/23
1236,1021,,max,-2,5,5,50%,10,2023/04/07
1237,1021,,TIny Rick,+1,10,10,50%,20,2023/04/16
1238,1021,,MintBerryCrunch,+1,7,8,47%,15,2023/03/27
1239,1021,,JPJE16,+1,12,12,50%,24,2023/04/13
1240,1021,,Uncle Soekarno,-2,15,14,52%,29,2023/04/12
1241,1021,,Rado,-1,15,13,54%,28,2023/03/27
1242,1020,,Tekk,-1,11,11,50%,22,2023/03/22
1243,1020,,tribo92,+3,16,19,46%,35,2023/04/09
1244,1020,,[LIVO]TheSorrow,+1,10,10,50%,20,2023/03/31
1245,1020,,Skullsmasher,-1,5,5,50%,10,2023/04/01
1246,1020,,Mister A.K.,-2,5,6,45%,11,2023/04/17
1247,1020,,Eversman,-3,27,26,51%,53,2023/04/01
1248,1020,,phobia,-3,7,7,50%,14,2023/03/25
1249,1020,,Iceman,-1,77,73,51%,150,2023/04/08
1250,1020,,DirtyDan,-2,9,9,50%,18,2023/04/01
1251,1020,,Ham,+1,63,61,51%,124,2023/04/09
1252,1019,,TeeCowley,-4,7,9,44%,16,2023/04/03
1253,1019,,noLiberation,+2,8,6,57%,14,2023/04/07
1254,1019,,Pharmacist,+1,12,11,52%,23,2023/04/12
1255,1019,,PaPaCrazy,+1,21,20,51%,41,2023/04/05
1256,1019,,p√©go,+2,37,35,51%,72,2023/04/17
1257,1019,,HW Plainview,+1,5,5,50%,10,2023/03/28
1258,1019,,Limbeater,+1,6,5,55%,11,2023/03/31
1259,1019,,ZIN,-2,45,39,54%,84,2023/04/11
1260,1019,,JustinTheLord,+1,40,34,54%,74,2023/04/04
1261,1019,,momo,-1,11,10,52%,21,2023/03/24
1262,1018,,Kimin,+3,50,47,52%,97,2023/04/08
1263,1018,,Cpt.Bod,-2,66,61,52%,127,2023/04/17
1264,1018,,Hussarius¬Æ,+1,8,7,53%,15,2023/04/02
1265,1018,,EsP _NieTO,-1,5,5,50%,10,2023/04/09
1266,1018,,LawKiller,+1,5,7,42%,12,2023/04/14
1267,1018,,OscarO,-1,16,12,57%,28,2023/04/15
1268,1018,,Guava,-2,5,5,50%,10,2023/03/30
1269,1017,,Rimjobs Anonymous,-5,15,16,48%,31,2023/03/24
1270,1017,,Nazca,-1,7,7,50%,14,2023/04/06
1271,1016,,SURVIVE,+3,6,5,55%,11,2023/04/15
1272,1016,,TheKingofRome,-3,24,26,48%,50,2023/03/23
1273,1016,,RPZWolf,-1,10,11,48%,21,2023/03/24
1274,1016,,Kryptonos,+3,5,5,50%,10,2023/04/14
1275,1016,,why so salty,-1,5,5,50%,10,2023/03/26
1276,1016,,AUGLER,+1,34,33,51%,67,2023/03/31
1277,1015,,Damgard,-3,19,21,48%,40,2023/03/23
1278,1015,,Soja,+1,9,9,50%,18,2023/04/06
1279,1015,,Hupsaiya,+3,7,7,50%,14,2023/04/06
1280,1014,,FeiLongÈ£õÈæç,+2,15,16,48%,31,2023/04/16
1281,1013,,Byakuyabo,+1,7,6,54%,13,2023/04/02
1282,1013,,The Major General,+3,8,8,50%,16,2023/04/16
1283,1013,,Winkston,-1,61,62,50%,123,2023/03/28
1284,1012,,da.zigounet,-1,19,16,54%,35,2023/04/16
1285,1012,,Rod,-3,27,24,53%,51,2023/04/14
1286,1012,,LoneRanger4744,+1,36,37,49%,73,2023/04/17
1287,1012,,T80U,+2,12,13,48%,25,2023/04/10
1288,1012,,Â®ÅÁåõÂÖàÁîü,+4,19,18,51%,37,2023/04/03
1289,1011,,Majeka23,+1,12,13,48%,25,2023/04/13
1290,1011,,ÊàëÂè™‰ºöÂøÉÁñºGIEGIE,+2,5,5,50%,10,2023/03/23
1291,1011,,Sharpe,-1,53,52,50%,105,2023/04/02
1292,1010,,clcarlos17,+1,6,6,50%,12,2023/03/22
1293,1010,,WinRar Trial,-1,18,18,50%,36,2023/04/15
1294,1010,,ArmenianDave,-4,11,14,44%,25,2023/03/25
1295,1010,,Rubielax,-2,9,10,47%,19,2023/03/28
1296,1010,,Operative,-2,97,95,51%,192,2023/04/01
1297,1010,,Chicken 4 Dayz,+2,37,29,56%,66,2023/04/06
1298,1010,,VewDew,-2,8,9,47%,17,2023/04/16
1299,1010,,Beaver steak,-1,20,21,49%,41,2023/04/02
1300,1010,,‚àû | BoCuoi,+2,7,7,50%,14,2023/04/01
1301,1010,,Zap,-1,6,5,55%,11,2023/04/01
1302,1010,,Webley's Webleys H20,-1,8,10,44%,18,2023/04/16
1303,1009,,witrilix,-2,15,14,52%,29,2023/04/07
1304,1009,,Trigger,-1,7,7,50%,14,2023/04/04
1305,1009,,Neodamus,+4,9,7,56%,16,2023/03/25
1306,1009,,Radioactive M3N,-5,23,22,51%,45,2023/03/21
1307,1009,,dorenwarren,+2,18,19,49%,37,2023/04/14
1308,1009,,HERMANATOR,-1,5,6,45%,11,2023/04/02
1309,1009,,Wind,-1,23,21,52%,44,2023/04/17
1310,1009,,Shogun1137,+2,6,6,50%,12,2023/04/06
1311,1008,,Aerozeppelin,+1,9,8,53%,17,2023/04/17
1312,1008,,The Great Tricktator,-2,5,5,50%,10,2023/04/04
1313,1008,,StorageRoom,-2,11,11,50%,22,2023/04/16
1314,1008,,Anthrax82,-1,6,6,50%,12,2023/03/24
1315,1008,,KaTH,+4,5,5,50%,10,2023/03/26
1316,1008,,Williams,+1,5,5,50%,10,2023/03/26
1317,1007,,Azely,+1,9,9,50%,18,2023/04/16
1318,1007,,TantheMan415,+2,114,112,50%,226,2023/04/17
1319,1007,,kinG_shrimP,-1,14,13,52%,27,2023/04/07
1320,1007,,Sk8erGirl,+2,5,5,50%,10,2023/03/28
1321,1006,,ÊàëË¶ÅÈÄ≤‰æÜ‰∫Ü,+3,7,6,54%,13,2023/04/11
1322,1006,,Vince,-2,11,13,46%,24,2023/04/02
1323,1006,,c0mplete,-4,10,14,42%,24,2023/03/21
1324,1006,,Brink,-2,7,7,50%,14,2023/04/15
1325,1006,,Sauzer88,+2,28,26,52%,54,2023/04/18
1326,1006,,PartTime_RebeL,-1,7,7,50%,14,2023/04/16
1327,1006,,GvardiA,+3,34,31,52%,65,2023/04/09
1328,1006,,PajaM5,+2,6,6,50%,12,2023/04/17
1329,1006,,First,-2,6,7,46%,13,2023/04/17
1330,1006,,chris nos,+1,6,7,46%,13,2023/04/09
1331,1006,,M-Maybe,-4,49,50,49%,99,2023/04/06
1332,1006,,Eccle,+5,15,12,56%,27,2023/03/26
1333,1006,,bubahey,-3,10,12,45%,22,2023/04/13
1334,1006,,WildCat,-3,9,10,47%,19,2023/04/16
1335,1006,,Fentalicous,-3,50,46,52%,96,2023/04/16
1336,1005,,ZiggyBig,-4,40,44,48%,84,2023/04/17
1337,1005,,enterprise9001,-2,5,6,45%,11,2023/03/22
1338,1005,,snafu,-1,16,13,55%,29,2023/04/02
1339,1005,,BiggieCheese,-2,21,25,46%,46,2023/04/16
1340,1005,,Psyikes,+1,9,9,50%,18,2023/03/26
1341,1005,,bigchunk1,+3,18,20,47%,38,2023/04/17
1342,1005,,Sher,-2,28,31,47%,59,2023/04/02
1343,1005,,~{Svain}~,+4,30,34,47%,64,2023/04/14
1344,1004,,Tmoney4,+3,8,9,47%,17,2023/04/10
1345,1004,,the doctor,+2,7,8,47%,15,2023/04/13
1346,1004,,Welly,-1,16,15,52%,31,2023/04/17
1347,1004,,Max1boy,-1,19,24,44%,43,2023/04/17
1348,1004,,Grizzle,-4,28,28,50%,56,2023/04/15
1349,1004,,Cyniczny cyp,-1,49,51,49%,100,2023/04/16
1350,1004,,Âà©Ê†πÁîüÂä©,+2,14,15,48%,29,2023/04/13
1351,1003,,Pajo,-4,36,33,52%,69,2023/03/27
1352,1003,,Êò•Êó•,+1,15,17,47%,32,2023/04/17
1353,1003,,Dziekan,-5,5,5,50%,10,2023/04/09
1354,1003,,PocketsLLP,+1,11,14,44%,25,2023/04/01
1355,1003,,unknownmagicmain,-1,5,5,50%,10,2023/03/21
1356,1003,,Mephswall,+1,15,13,54%,28,2023/04/02
1357,1003,,Pacman - Animarchy,+1,18,18,50%,36,2023/04/07
1358,1002,,Ultra,+3,18,17,51%,35,2023/04/07
1359,1002,,Noshi,+2,6,6,50%,12,2023/03/31
1360,1002,,Morbid Git,+2,21,26,45%,47,2023/04/15
1361,1002,,ZEB,+1,6,6,50%,12,2023/04/16
1362,1002,,NickTheHunt,+1,13,13,50%,26,2023/04/09
1363,1002,,‚ô®TEA.UP¬Æ‚ô®RGeraldo,+2,6,6,50%,12,2023/04/11
1364,1001,,ViseBro,-1,61,57,52%,118,2023/04/16
1365,1001,,Prancey,-2,6,7,46%,13,2023/04/10
1366,1001,,cadlab,+1,15,15,50%,30,2023/04/17
1367,1001,,ICH BIN SCHNAPPI,+1,6,5,55%,11,2023/04/12
1368,1001,,princip,+1,6,6,50%,12,2023/04/16
1369,1000,,DarkRun,+2,38,34,53%,72,2023/04/16
1370,1000,,Nubbl0r,+1,16,14,53%,30,2023/04/01
1371,1000,,rocketpossum,+1,8,9,47%,17,2023/04/04
1372,1000,,The_Buccaneer,+3,133,127,51%,260,2023/04/17
1373,1000,,EastHawk,-1,25,28,47%,53,2023/04/17
1374,1000,,Jelic,-1,14,18,44%,32,2023/03/23
1375,1000,,Asmodai,-2,34,33,51%,67,2023/04/06
1376,1000,,Dr.Draese,-4,13,15,46%,28,2023/04/01
1377,999,,SolidRaziel,-1,12,12,50%,24,2023/03/29
1378,999,,Sheepdogsheep,-1,22,18,55%,40,2023/04/10
1379,999,,Tap57,+2,5,5,50%,10,2023/04/11
1380,999,,piffy,+1,17,20,46%,37,2023/03/25
1381,999,,LITTLESUN,-4,68,69,50%,137,2023/04/15
1382,998,,Draakul,-3,5,5,50%,10,2023/03/21
1383,998,,Luz Noceda,+3,16,12,57%,28,2023/04/09
1384,998,,ÈÑô‰∫∫ÂºµÈ∫ªÂ≠ê,+3,13,12,52%,25,2023/04/10
1385,998,,LikioOo,+6,8,7,53%,15,2023/04/02
1386,998,,UndeadNinja,-1,5,5,50%,10,2023/04/02
1387,998,,Makketsai,+1,10,10,50%,20,2023/04/17
1388,997,,Tuxedo Shirt Jesus,+1,37,38,49%,75,2023/04/07
1389,997,,2 Blessed 2 Be Stressed,-5,5,7,42%,12,2023/04/16
1390,997,,Smitty2,-3,8,8,50%,16,2023/04/03
1391,997,,LinSir,-1,12,11,52%,23,2023/04/11
1392,996,,Ygod,+1,6,7,46%,13,2023/03/21
1393,996,,Dr Flankenstein,-2,35,36,49%,71,2023/04/16
1394,996,,Pickin_Chickin(Duck),-3,6,6,50%,12,2023/03/27
1395,996,,Ware0193,-2,7,8,47%,15,2023/04/08
1396,996,,XrusTim,-1,56,50,53%,106,2023/04/15
1397,995,,shz007,-2,15,19,44%,34,2023/04/08
1398,995,,Smokindro420,+2,14,13,52%,27,2023/04/06
1399,995,,Friend Simulator,-3,33,39,46%,72,2023/04/15
1400,995,,Frostfire,-1,6,6,50%,12,2023/03/21
1401,995,,BENDER,+1,58,65,47%,123,2023/03/25
1402,995,,sirota,-1,30,26,54%,56,2023/04/17
1403,994,,stonda.m,-2,31,31,50%,62,2023/04/17
1404,994,,unID101,-3,9,12,43%,21,2023/03/27
1405,994,,I_Lov_Anime_Titties,-3,19,21,48%,40,2023/04/15
1406,994,,Jopjahh,-1,6,5,55%,11,2023/04/10
1407,993,,raylix,-1,10,9,53%,19,2023/04/10
1408,993,,Zorro,+2,16,17,48%,33,2023/04/06
1409,993,,FenneQ,-4,35,35,50%,70,2023/04/17
1410,993,,John Êæ§Êù±,-1,26,22,54%,48,2023/04/15
1411,992,,MarioCZ,-1,5,6,45%,11,2023/03/22
1412,992,,headake,-2,22,24,48%,46,2023/03/29
1413,992,,Mattchop,+1,18,19,49%,37,2023/04/17
1414,992,,Sir Petecchio,+1,9,8,53%,17,2023/04/12
1415,992,,MaDDo (:,-1,8,8,50%,16,2023/04/12
1416,992,,baschi,+1,27,26,51%,53,2023/04/17
1417,991,,jamister911,+1,42,40,51%,82,2023/04/17
1418,991,,ReliantX,+2,27,30,47%,57,2023/04/16
1419,991,,Jeune Anko (¬¥ÔΩ•œâÔΩ•`),-1,28,28,50%,56,2023/03/29
1420,990,,Dr. T,-4,11,13,46%,24,2023/04/13
1421,990,,helloELeven,+1,39,40,49%,79,2023/04/05
1422,990,,sladjanbre,+2,17,17,50%,34,2023/04/08
1423,990,,SpeedSIM,-2,20,20,50%,40,2023/04/17
1424,990,,darkjourneyman,-2,31,42,42%,73,2023/04/16
1425,989,,dotvz,+5,37,36,51%,73,2023/04/03
1426,989,,DeathBringeR,-3,16,15,52%,31,2023/04/16
1427,989,,ShooterWorld,+1,41,39,51%,80,2023/04/02
1428,988,,notrangerjoe,-2,4,6,40%,10,2023/04/14
1429,988,,Havock,-3,89,94,49%,183,2023/04/10
1430,988,,videotext2,-1,6,7,46%,13,2023/04/16
1431,988,,Saint Michael,-1,15,14,52%,29,2023/04/15
1432,988,,James Bond,-2,4,6,40%,10,2023/03/30
1433,987,,Mr. Cream,-1,6,6,50%,12,2023/04/12
1434,987,,Roamin,-1,11,12,48%,23,2023/04/12
1435,987,,IdARzikFTh,+1,11,12,48%,23,2023/03/30
1436,987,,RoyaalDutch,-1,15,17,47%,32,2023/04/10
1437,987,,Mook Spits,+3,5,6,45%,11,2023/03/31
1438,987,,Zealot,-2,10,12,45%,22,2023/04/05
1439,987,,Deathmatch,+2,21,16,57%,37,2023/04/06
1440,987,,aweatherbee0131,-2,9,11,45%,20,2023/04/06
1441,987,,LokoTypie,+1,5,6,45%,11,2023/03/26
1442,986,,niksa,-1,16,15,52%,31,2023/04/07
1443,986,,Schroedinger's Cat,+2,14,14,50%,28,2023/04/14
1444,986,,[GG]Onkel Stonkel,-1,6,8,43%,14,2023/04/15
1445,986,,Steiner85,-2,4,6,40%,10,2023/04/12
1446,986,,Thunderbolt 101,-4,7,7,50%,14,2023/04/17
1447,985,,jovo,-1,5,6,45%,11,2023/04/04
1448,985,,Hanger,-3,13,13,50%,26,2023/04/01
1449,985,,Shorty,+1,7,8,47%,15,2023/03/22
1450,985,,alex1506,-3,12,11,52%,23,2023/03/29
1451,985,,meow,-3,13,15,46%,28,2023/04/01
1452,984,,sleepysmartass5,-2,33,40,45%,73,2023/04/06
1453,984,,Four Friendly Brown Men,-1,8,8,50%,16,2023/04/07
1454,984,,MoonfireSpam,-5,23,27,46%,50,2023/03/31
1455,983,,Toaster Lover,-3,7,8,47%,15,2023/04/08
1456,983,,toto,+1,14,14,50%,28,2023/04/15
1457,983,,Jurek Kiler,-3,13,16,45%,29,2023/04/15
1458,983,,RN42,+6,25,26,49%,51,2023/04/17
1459,983,,Stevpa1,-2,27,31,47%,58,2023/04/17
1460,983,,Apemanx,+2,7,7,50%,14,2023/03/21
1461,983,,RadialEngine,+4,11,10,52%,21,2023/04/16
1462,982,,Bineto,-1,64,65,50%,129,2023/04/02
1463,982,,Sigma4Life,-1,84,87,49%,171,2023/04/14
1464,982,,ACE_28,+1,65,65,50%,130,2023/04/16
1465,982,,tanne455,-2,32,28,53%,60,2023/04/01
1466,982,,Bludd76,-1,5,8,38%,13,2023/04/16
1467,982,,Baddentist,-1,36,35,51%,71,2023/04/05
1468,982,,Gautgoth (FR),-2,8,10,44%,18,2023/04/03
1469,982,,BruinTzar,-1,10,11,48%,21,2023/04/17
1470,981,,Prophet of Truth,-4,7,9,44%,16,2023/04/10
1471,981,,MariusMarius,-4,23,24,49%,47,2023/04/17
1472,981,,Arnold,+1,9,10,47%,19,2023/04/10
1473,981,,Franjopo,-4,7,8,47%,15,2023/03/24
1474,981,,Adeney,-2,19,22,46%,41,2023/04/15
1475,981,,ColdBlood,-1,33,36,48%,69,2023/04/11
1476,981,,Capt.Photon,+1,12,12,50%,24,2023/04/06
1477,981,,Twitch.tv/DirtyKar1,+3,6,6,50%,12,2023/04/01
1478,980,,Sgt.DasheRRR,+1,50,53,49%,103,2023/04/17
1479,980,,amateur shut in,-3,16,17,48%,33,2023/04/17
1480,980,,yeahbam,-3,11,13,46%,24,2023/03/30
1481,980,,SulumEi,+2,9,8,53%,17,2023/04/17
1482,980,,waffle_dogg,+1,52,51,50%,103,2023/04/06
1483,980,,St. Bucko Slays the Dragon,-1,23,22,51%,45,2023/04/15
1484,980,,Á®≥Âæó‰Ωè0.0,+1,8,7,53%,15,2023/04/14
1485,980,,LEOMNERY,-3,7,9,44%,16,2023/04/14
1486,980,,gtmike,-1,17,17,50%,34,2023/04/09
1487,979,,usmc961,-1,13,15,46%,28,2023/04/11
1488,979,,Seshino,-4,8,8,50%,16,2023/03/30
1489,979,,MiaKhalifa,-2,8,8,50%,16,2023/03/28
1490,979,,sniper,-2,6,8,43%,14,2023/04/05
1491,979,,Citathat,-3,20,21,49%,41,2023/04/08
1492,978,,Armless Guy Gaming,-3,40,38,51%,78,2023/04/14
1493,978,,Dromnk,-4,12,13,48%,25,2023/04/04
1494,978,,Sev,-2,13,17,43%,30,2023/04/04
1495,978,,Nu_Ohm,-1,10,11,48%,21,2023/04/06
1496,978,,Prof. Fart's Sniff Emporium,-2,5,5,50%,10,2023/03/21
1497,978,,WhiteWhale42,-1,5,6,45%,11,2023/03/31
1498,978,,Radu S.a.v.,-2,7,9,44%,16,2023/03/27
1499,978,,this51,+5,35,36,49%,71,2023/04/16
1500,977,,Antidote,-3,9,11,45%,20,2023/04/17
1501,977,,Bobtinator,-3,7,8,47%,15,2023/04/17
1502,977,,Till Forever Falls Apart,+2,5,5,50%,10,2023/03/25
1503,977,,UHD Lovecraft,-1,9,12,43%,21,2023/04/14
1504,977,,Sugar Scoot,-1,40,41,49%,81,2023/03/21
1505,977,,(KCC)Luci,-1,24,24,50%,48,2023/04/02
1506,976,,Libanese_de_Roma,+1,35,34,51%,69,2023/04/01
1507,976,,carpediem,-2,7,8,47%,15,2023/04/02
1508,976,,Ê∫∫Ê∞¥ÁöÑÂ∑®‰∫∫,+4,6,6,50%,12,2023/03/25
1509,975,,Tueur,+2,11,12,48%,23,2023/04/08
1510,975,,Ultra,+1,7,10,41%,17,2023/04/17
1511,975,,Ookiemouth,+2,8,9,47%,17,2023/04/12
1512,975,,SuperFly,+1,9,12,43%,21,2023/04/13
1513,974,,Clint Toastwood,+1,28,28,50%,56,2023/03/24
1514,974,,Im That Guy,+1,7,9,44%,16,2023/04/15
1515,974,,Im_Gary,-2,17,14,55%,31,2023/03/30
1516,974,,tediousgraffiti,-1,5,6,45%,11,2023/04/05
1517,974,,Quid,-1,5,6,45%,11,2023/03/25
1518,973,,Frutton,-3,43,39,52%,82,2023/04/17
1519,973,,CravattiSeiKumpel,-1,7,8,47%,15,2023/03/22
1520,972,,1197263532,-1,32,32,50%,64,2023/04/14
1521,972,,Tidenhub,+1,5,6,45%,11,2023/03/24
1522,972,,jingleswj,-2,39,43,48%,82,2023/04/16
1523,972,,ghey fish,+1,26,23,53%,49,2023/04/17
1524,972,,=‚òÖ= Iron Hawk =‚òÖ=,+1,36,40,47%,76,2023/04/08
1525,972,,birdhouse,-3,48,49,49%,97,2023/04/17
1526,972,,ya,-2,12,15,44%,27,2023/03/25
1527,971,,DJ BISCUIT,-1,14,15,48%,29,2023/04/01
1528,971,,(Y.G.) General Feraud,-2,7,8,47%,15,2023/04/13
1529,971,,GaijinEnterprises,-1,6,7,46%,13,2023/03/23
1530,971,,TheMandoX2,-1,50,48,51%,98,2023/04/02
1531,970,,imJBOX,-1,11,13,46%,24,2023/04/12
1532,970,,Webby,+3,9,10,47%,19,2023/04/03
1533,970,,Mustard Rat,+1,6,8,43%,14,2023/04/09
1534,969,,legranduke,+5,8,8,50%,16,2023/04/03
1535,969,,Light,+1,19,19,50%,38,2023/03/28
1536,969,,Saji Crossroad,-3,13,17,43%,30,2023/04/11
1537,968,,‡πñ€£inGODweTrust€ú,+1,16,18,47%,34,2023/04/13
1538,968,,HIGH ON FALAFEL AND RICE,+3,7,6,54%,13,2023/03/22
1539,968,,OhSnap,+1,41,44,48%,85,2023/04/15
1540,968,,Clip Clopernicus,-1,17,23,43%,40,2023/04/17
1541,968,,Jtownokie,-5,22,24,48%,46,2023/04/03
1542,968,,BHPGuRuAon,-2,13,15,46%,28,2023/04/16
1543,968,,Movai,-1,11,15,42%,26,2023/04/10
1544,968,,Thigoron,-4,5,7,42%,12,2023/04/04
1545,968,,bungleman,+2,60,63,49%,123,2023/04/15
1546,967,,Lemonrocks1,+1,13,13,50%,26,2023/03/31
1547,967,,ChayTH,+3,9,11,45%,20,2023/04/11
1548,967,,SinTacos,-1,109,117,48%,226,2023/04/17
1549,966,,albertoKR,-4,6,9,40%,15,2023/04/01
1550,966,,Nexus,-3,14,15,48%,29,2023/04/12
1551,965,,zxzxzx207,-1,10,13,43%,23,2023/04/17
1552,965,,Ros3ncrantz,-1,5,6,45%,11,2023/04/09
1553,965,,SergeSeal,+1,6,10,38%,16,2023/04/10
1554,965,,wong.wilfred,-1,8,8,50%,16,2023/04/14
1555,965,,Nello the Tiger,+2,18,14,56%,32,2023/04/01
1556,964,,Gnarboots,+1,9,11,45%,20,2023/03/25
1557,964,,diritar,-4,32,28,53%,60,2023/04/14
1558,964,,Major Gladouze,-1,14,15,48%,29,2023/04/09
1559,964,,johny247trace,+3,6,9,40%,15,2023/04/06
1560,964,,GeneralMosti,-1,20,18,53%,38,2023/03/23
1561,964,,Demi,+5,19,18,51%,37,2023/04/14
1562,964,,FritzFranz,-4,4,6,40%,10,2023/03/29
1563,964,,indu,-2,20,21,49%,41,2023/04/17
1564,963,,Broski,-2,13,13,50%,26,2023/03/22
1565,963,,La Crevette,-2,10,14,42%,24,2023/04/13
1566,963,,maciekmacc87,-4,9,14,39%,23,2023/04/02
1567,963,,Vizantum,+2,6,8,43%,14,2023/04/17
1568,963,,NomadDuNord,+1,11,12,48%,23,2023/04/14
1569,963,,kim2802ks,-3,8,9,47%,17,2023/03/23
1570,963,,Azildrake,-2,5,7,42%,12,2023/03/29
1571,962,,Let me boom,-5,55,54,50%,109,2023/04/17
1572,962,,frodoswaggins24,-2,22,24,48%,46,2023/04/01
1573,961,,ceramicrooster,-2,16,17,48%,33,2023/04/08
1574,961,,Latimer,+1,5,7,42%,12,2023/04/16
1575,961,,Toby Fayre,+1,3,7,30%,10,2023/04/17
1576,961,,R2D2,-2,63,63,50%,126,2023/04/16
1577,960,,aLaBaMaBa01,-5,5,6,45%,11,2023/04/02
1578,960,,smithers43,+2,37,37,50%,74,2023/04/16
1579,960,,Rex Everything,-1,6,8,43%,14,2023/04/13
1580,960,,Seal Sandwich,-3,9,13,41%,22,2023/03/28
1581,960,,BadAssArmy,+1,5,6,45%,11,2023/03/26
1582,959,,Hearts&Minds,-2,55,55,50%,110,2023/03/24
1583,959,,extince,+1,91,83,52%,174,2023/04/17
1584,959,,RogueTrooper34,-1,5,8,38%,13,2023/04/08
1585,959,,hadeS*,-1,34,38,47%,72,2023/04/02
1586,958,,erectusapes,-2,8,11,42%,19,2023/04/17
1587,958,,skitchss,+2,13,16,45%,29,2023/04/16
1588,958,,AbleCompany,+3,12,14,46%,26,2023/04/02
1589,958,,Mittchell,-2,5,7,42%,12,2023/04/03
1590,958,,MikoMikoSpark,-2,6,11,35%,17,2023/04/15
1591,958,,TTONAK,-1,5,8,38%,13,2023/04/07
1592,958,,hlingying,+1,24,29,45%,53,2023/04/02
1593,957,,MacReady,+5,15,13,54%,28,2023/04/05
1594,957,,fuzzbunny funk,-1,5,8,38%,13,2023/04/11
1595,957,,‰∫åÊù°Èô¢ÁæΩÊúà,+1,7,7,50%,14,2023/04/16
1596,957,,thepaleking,-3,5,8,38%,13,2023/03/31
1597,957,,Cinder,-4,22,24,48%,46,2023/04/08
1598,956,,Pain_Inside,-2,17,16,52%,33,2023/04/17
1599,956,,Suby,-1,7,8,47%,15,2023/04/07
1600,956,,Evil Techwolf,-4,4,10,29%,14,2023/04/16
1601,956,,ÌÅêÏüå,-1,10,10,50%,20,2023/04/12
1602,955,,Capn Vyse,-1,14,17,45%,31,2023/04/17
1603,955,,Fookin' Laser Sights,+1,11,14,44%,25,2023/04/09
1604,955,,Carpy,-2,12,13,48%,25,2023/04/10
1605,954,,DwarfKingHack,-3,10,17,37%,27,2023/04/06
1606,954,,No this is patrick,-1,19,24,44%,43,2023/04/14
1607,954,,Tarkin,+1,11,13,46%,24,2023/04/17
1608,954,,Cervenyrajce,+2,18,17,51%,35,2023/03/31
1609,954,,zenvinyl,+1,6,7,46%,13,2023/04/09
1610,954,,gman5555555555,-2,7,9,44%,16,2023/04/16
1611,954,,Tornholio,+2,46,56,45%,102,2023/04/15
1612,953,,wapa33,-1,19,18,51%,37,2023/03/25
1613,953,,King CCM,-1,11,13,46%,24,2023/04/05
1614,953,,PureHydro,-1,17,15,53%,32,2023/03/30
1615,953,,Drax,+5,9,10,47%,19,2023/04/11
1616,952,,Ic√•rus,-2,7,13,35%,20,2023/04/14
1617,952,,Shirka,+1,14,14,50%,28,2023/04/16
1618,952,,Hans_Hackfresse,-1,11,14,44%,25,2023/04/06
1619,952,,Bezukhov,-3,59,63,48%,122,2023/04/07
1620,952,,MonkeyWang,-2,7,11,39%,18,2023/04/15
1621,952,,Rogozilla,+2,39,43,48%,82,2023/04/17
1622,951,,Snoopy,-1,12,14,46%,26,2023/04/10
1623,951,,Shogun,-2,10,16,38%,26,2023/03/29
1624,951,,Èò≥ÂÖâÊûúÁ≤íÊ©ô,-1,8,11,42%,19,2023/04/09
1625,951,,X-BURNER,-1,23,22,51%,45,2023/03/24
1626,950,,bobinpants,+1,4,6,40%,10,2023/04/08
1627,949,,le R√©gent,+1,6,7,46%,13,2023/04/07
1628,949,,"Jesus Christ Loves You, Ask Him",+2,11,12,48%,23,2023/04/07
1629,949,,donna is my maker,+1,4,7,36%,11,2023/04/15
1630,949,,Zipotonez,+1,16,17,48%,33,2023/03/25
1631,949,,MaXimumCarnage!!!,+1,157,196,44%,353,2023/04/17
1632,949,,MARTINE,-2,16,15,52%,31,2023/03/30
1633,949,,Naoned,-1,33,35,49%,68,2023/04/07
1634,949,,Secret Chicken,-1,6,6,50%,12,2023/04/02
1635,949,,sei40701,-2,4,6,40%,10,2023/03/27
1636,949,,que,-2,29,29,50%,58,2023/03/31
1637,949,,Beyn,-1,5,6,45%,11,2023/03/29
1638,948,,RTveda,-1,6,9,40%,15,2023/04/14
1639,948,,–ß–µ,-3,42,46,48%,88,2023/04/06
1640,947,,XJ_Adam,-1,5,8,38%,13,2023/03/24
1641,947,,etaif69,+2,5,10,33%,15,2023/04/08
1642,947,,tewnclub,-1,5,6,45%,11,2023/04/16
1643,947,,xanto,+4,13,11,54%,24,2023/03/25
1644,946,,Crog,-2,5,7,42%,12,2023/04/12
1645,946,,Colonel Klink,-4,3,7,30%,10,2023/04/05
1646,946,,FrDiZz,+1,33,36,48%,69,2023/04/17
1647,945,,RGJTony1313,-1,5,7,42%,12,2023/04/10
1648,945,,guarnere478,+4,59,64,48%,123,2023/04/16
1649,945,,AboWifMaccas,+1,9,11,45%,20,2023/03/29
1650,945,,Prussian Bot,-1,5,7,42%,12,2023/04/17
1651,945,,Elik,+1,6,8,43%,14,2023/03/21
1652,944,,"It was just, banter",+1,7,9,44%,16,2023/03/30
1653,944,,Mick,-2,4,6,40%,10,2023/04/06
1654,944,,Mr.X,+1,38,40,49%,78,2023/04/10
1655,944,,DovDim,+1,53,53,50%,106,2023/04/05
1656,944,,^kuku,-2,6,9,40%,15,2023/04/13
1657,943,,Tiraskis,+1,20,23,47%,43,2023/04/02
1658,943,,Scream,+1,10,12,45%,22,2023/04/05
1659,943,,Arty,-1,3,7,30%,10,2023/04/12
1660,942,,Preytor,+1,24,35,41%,59,2023/04/16
1661,942,,Rick_Astley,-2,4,7,36%,11,2023/03/27
1662,942,,CDCusa,-1,25,29,46%,54,2023/04/16
1663,942,,ethirty,-1,11,18,38%,29,2023/04/02
1664,942,,Myrn,+2,13,20,39%,33,2023/04/16
1665,941,,Uncle Grandpa,+1,16,19,46%,35,2023/04/05
1666,941,,Sophia,+2,6,7,46%,13,2023/03/22
1667,941,,Ïó∞Ï¥ù,-1,5,6,45%,11,2023/03/29
1668,941,,TheSnappyTom,-2,145,152,49%,297,2023/04/09
1669,941,,Cat Biscuits,+1,12,16,43%,28,2023/04/13
1670,940,,thatguy1122,+1,7,6,54%,13,2023/04/17
1671,940,,SKZaldivar,-2,5,7,42%,12,2023/04/10
1672,940,,Slade,+4,33,42,44%,75,2023/04/13
1673,940,,Scarecrow,+2,6,8,43%,14,2023/03/22
1674,939,,Captain Clix,+1,40,45,47%,85,2023/04/10
1675,939,,Hardkaise,-4,8,13,38%,21,2023/03/22
1676,939,,{BOOL} Bro_Boi,+1,5,5,50%,10,2023/04/17
1677,939,,lichung_yu,+1,46,51,47%,97,2023/04/17
1678,939,,√üoo,-1,41,46,47%,87,2023/04/15
1679,939,,{-.{-.{ Ur Mom }.-}.-},+1,8,11,42%,19,2023/04/17
1680,939,,AndreMafia,+1,10,13,43%,23,2023/04/17
1681,939,,BigTymer,-2,10,13,43%,23,2023/03/24
1682,939,,CryPsyco,+2,14,15,48%,29,2023/04/01
1683,939,,Dolphin54,-1,7,9,44%,16,2023/03/23
1684,938,,aska4120,-1,4,7,36%,11,2023/04/02
1685,938,,Get Ricked Rolled,+1,25,30,45%,55,2023/04/16
1686,938,,El Patr√≥n,-2,4,8,33%,12,2023/03/30
1687,938,,popopopop,+1,5,8,38%,13,2023/04/16
1688,938,,Yaguaret√©,+1,55,60,48%,115,2023/04/15
1689,937,,abds500,-4,6,11,35%,17,2023/03/30
1690,937,,Azureye,+1,7,10,41%,17,2023/04/17
1691,937,,CYBORGOR,-1,4,6,40%,10,2023/03/25
1692,937,,ship60,-3,6,9,40%,15,2023/03/22
1693,937,,HULUANDBUTTSTUFF175,-4,24,34,41%,58,2023/03/30
1694,937,,IIIIIIIIIIIIIIIII:-P,+2,10,11,48%,21,2023/03/24
1695,936,,Superchabo,-2,10,13,43%,23,2023/03/30
1696,936,,Milky Waters,-2,6,8,43%,14,2023/04/13
1697,936,,pycholon,-1,13,17,43%,30,2023/04/10
1698,936,,Fidel Cashflow,+1,4,6,40%,10,2023/04/18
1699,936,,Dat_Cat,+6,22,23,49%,45,2023/04/17
1700,936,,W4RFIGH7ER,-2,10,12,45%,22,2023/04/14
1701,935,,obvious_gamer,+1,4,6,40%,10,2023/03/31
1702,935,,Freeman.,+1,6,8,43%,14,2023/03/23
1703,935,,[TTV]Under_Keep,+2,5,6,45%,11,2023/04/17
1704,934,,AlexanderTGreat,-5,66,69,49%,135,2023/04/14
1705,934,,mkaye,-3,17,20,46%,37,2023/03/28
1706,934,,SICkNick,-1,33,38,46%,71,2023/04/17
1707,934,,Rummel,+1,16,16,50%,32,2023/04/16
1708,934,,NorthWestFresh,+1,10,16,38%,26,2023/04/11
1709,933,,Bloodraven,-2,23,26,47%,49,2023/04/10
1710,933,,Tootoone88,-5,16,21,43%,37,2023/04/17
1711,933,,PDDÂêõÊÑè-Ëã±ÈõÑËøû3-01,-2,7,9,44%,16,2023/04/05
1712,932,,Toco Velho,+2,57,67,46%,124,2023/04/18
1713,932,,danrylee,+2,11,14,44%,25,2023/03/30
1714,931,,0RCcA,-5,32,39,45%,71,2023/04/15
1715,931,,Kanonenvogel,+1,9,13,41%,22,2023/04/08
1716,931,,calele,+2,11,14,44%,25,2023/03/23
1717,931,,Mi≈°√°k Moravan.,-2,30,39,43%,69,2023/04/12
1718,931,,SDS|DarkCalis,-2,11,13,46%,24,2023/03/27
1719,931,,PhantomErection,-2,20,23,47%,43,2023/04/15
1720,930,,Ztorm,+1,62,65,49%,127,2023/04/09
1721,930,,Trapped in NA,-2,4,7,36%,11,2023/03/31
1722,930,,God Emperor,-2,6,8,43%,14,2023/04/14
1723,930,,FuelTank,-2,23,23,50%,46,2023/04/16
1724,930,,nukeproof,-1,4,6,40%,10,2023/03/21
1725,929,,La Boule,+1,8,12,40%,20,2023/04/09
1726,929,,Moiz_Dray,-3,15,17,47%,32,2023/04/11
1727,929,,tede00,-1,15,19,44%,34,2023/04/17
1728,929,,The Miracle,+3,7,10,41%,17,2023/04/15
1729,929,,FR3LLE,-1,10,10,50%,20,2023/04/11
1730,929,,AlCapwnage,-2,9,13,41%,22,2023/03/23
1731,928,,MADE OF SNOW,+2,5,8,38%,13,2023/04/03
1732,928,,marwit,-1,27,31,47%,58,2023/03/29
1733,928,,XCAMELDEALERX,-2,9,15,38%,24,2023/04/17
1734,928,,Shibiman,-1,5,7,42%,12,2023/04/15
1735,928,,m.burr,+1,4,7,36%,11,2023/04/16
1736,928,,NachoVidanal,-4,15,20,43%,35,2023/04/05
1737,927,,JTSnake,-1,49,53,48%,102,2023/04/02
1738,927,,Headi,-1,5,7,42%,12,2023/03/30
1739,927,,KING,+4,5,6,45%,11,2023/03/26
1740,926,,Daegorol,-1,11,13,46%,24,2023/03/23
1741,926,,jwilliams0747,+2,17,25,40%,42,2023/03/31
1742,926,,ChunKee,+1,20,24,45%,44,2023/04/17
1743,926,,Âç≥Â∞ÜÊàê‰∏∫Ëã±ÈõÑ,-1,18,25,42%,43,2023/04/11
1744,926,,GreenTech,-5,22,33,40%,55,2023/04/15
1745,926,,Fedain,+3,11,12,48%,23,2023/04/17
1746,926,,SUPACAUSAL,+1,109,120,48%,229,2023/04/11
1747,926,,TerpeneProfile,-2,16,26,38%,42,2023/04/13
1748,926,,AustrianBastard,-2,23,25,48%,48,2023/04/12
1749,925,,Diamondgg„ãõ ‚óï‚Äø‚óï,-4,20,23,47%,43,2023/04/16
1750,925,,lwaclaws,-3,18,23,44%,41,2023/04/16
1751,925,,Corpse,+1,7,8,47%,15,2023/04/10
1752,925,,HERMAN,-2,28,29,49%,57,2023/04/17
1753,925,,You Bring Me Fight,-1,5,7,42%,12,2023/04/13
1754,924,,TheBananaEffect,-3,5,7,42%,12,2023/04/06
1755,924,,Rakkammecc,+2,26,30,46%,56,2023/03/25
1756,924,,CRISPI Richard,-1,7,10,41%,17,2023/04/07
1757,924,,Angry Leo,+2,11,16,41%,27,2023/04/17
1758,924,,Èü¨Âä†Â≠ê,+1,30,39,43%,69,2023/04/12
1759,924,,Anker,+1,36,40,47%,76,2023/04/17
1760,923,,Apollo,+1,172,192,47%,364,2023/04/16
1761,923,,i just stupid korean,-3,7,10,41%,17,2023/03/30
1762,923,,Milo,+1,5,9,36%,14,2023/04/17
1763,922,,efjot_ep,-3,28,29,49%,57,2023/04/02
1764,922,,tjwalleck9999,-1,10,12,45%,22,2023/04/14
1765,922,,T4dwarfman,+1,5,9,36%,14,2023/04/16
1766,922,,kiwisteel_95,+2,12,15,44%,27,2023/04/10
1767,922,,Bodaaa,-3,12,15,44%,27,2023/04/13
1768,922,,Milan,-2,5,5,50%,10,2023/04/16
1769,922,,jokur,+1,9,10,47%,19,2023/04/05
1770,921,,(CB7) (DU)(7-4-7)(B0iz),-3,24,34,41%,58,2023/04/14
1771,921,,qducryzz,+1,31,34,48%,65,2023/04/05
1772,921,,ArcticFox,-3,4,7,36%,11,2023/04/02
1773,920,,jeffseasons,+2,42,47,47%,89,2023/04/15
1774,920,,Step,+1,11,13,46%,24,2023/04/13
1775,920,,Gauss2718,-1,7,10,41%,17,2023/03/25
1776,919,,Krisdt,-2,12,16,43%,28,2023/04/09
1777,919,,Asmor,+4,12,18,40%,30,2023/04/17
1778,918,,Grando[TW],-5,5,9,36%,14,2023/03/30
1779,918,,–Ω—ï | Poptart,-4,4,6,40%,10,2023/04/08
1780,918,,simia.dei,-3,26,29,47%,55,2023/04/13
1781,918,,Kaesar,-2,9,14,39%,23,2023/04/01
1782,918,,Fischius84,-1,10,13,43%,23,2023/03/23
1783,917,,–≤–µ–ª–∏–∫–∞—è –ö–∞—Ç—é—à–∞,-2,8,12,40%,20,2023/04/14
1784,917,,The Punisher,+2,4,6,40%,10,2023/03/26
1785,917,,DirtySanchez,-1,12,18,40%,30,2023/04/15
1786,917,,Exige,+1,4,7,36%,11,2023/03/21
1787,916,,MIIIKU39,+1,6,8,43%,14,2023/04/09
1788,916,,Chief,+1,16,21,43%,37,2023/03/29
1789,916,,Brock,-1,7,10,41%,17,2023/04/13
1790,916,,Hepa,+1,10,15,40%,25,2023/03/24
1791,915,,Capt1nToast,+1,10,17,37%,27,2023/04/16
1792,915,,PzKwkanone,+3,11,14,44%,25,2023/03/29
1793,915,,JackBauer,-2,5,7,42%,12,2023/04/08
1794,915,,JEWPITER,-5,26,35,43%,61,2023/04/16
1795,914,,Soruz,-1,13,20,39%,33,2023/04/03
1796,914,,SOSO,+1,53,66,45%,119,2023/04/10
1797,914,,Vemaster,-2,5,8,38%,13,2023/04/17
1798,913,,=BiA=madafaka,+1,6,9,40%,15,2023/03/29
1799,913,,NoReachAroundForYou,-3,3,8,27%,11,2023/03/28
1800,913,,Tritolo,-1,9,11,45%,20,2023/04/02
1801,913,,RKarpenter,-2,21,25,46%,46,2023/04/06
1802,913,,sadum1206,+2,31,41,43%,72,2023/04/17
1803,912,,Dominus August,-3,14,16,47%,30,2023/03/28
1804,912,,Death-Bringer,-1,22,27,45%,49,2023/04/12
1805,912,,anthrod,+2,30,35,46%,65,2023/04/17
1806,912,,Toni,+1,8,11,42%,19,2023/03/22
1807,912,,Cdawg_24,-1,5,7,42%,12,2023/04/09
1808,911,,Killer_bunny,-2,8,10,44%,18,2023/04/17
1809,911,,Kayne,+1,12,19,39%,31,2023/04/16
1810,910,,Eat_Sleep_Dave_Repeat,-1,17,16,52%,33,2023/03/24
1811,910,,Zorro S.A.S,-3,19,25,43%,44,2023/04/17
1812,910,,XxPaNdAsCoPsxX,-2,4,6,40%,10,2023/04/09
1813,910,,Heizenberg,-1,12,18,40%,30,2023/04/13
1814,910,,Tw_Yolin,-2,13,19,41%,32,2023/04/02
1815,910,,ùìûùîÖùêº,+2,14,21,40%,35,2023/04/17
1816,910,,weihau11051988,+1,5,10,33%,15,2023/04/16
1817,910,,PressLIT,+2,9,12,43%,21,2023/03/31
1818,910,,\3j√∏rkm4n,+1,5,9,36%,14,2023/03/30
1819,910,,emperor_marcus,-1,7,10,41%,17,2023/03/28
1820,909,,Hipo,-3,15,20,43%,35,2023/04/14
1821,909,,CarlSagan69,+1,4,8,33%,12,2023/04/10
1822,909,,Howi,+1,7,12,37%,19,2023/04/14
1823,909,,Sardine,-6,5,11,31%,16,2023/03/31
1824,909,,alex0irimia,+2,7,11,39%,18,2023/04/12
1825,909,,TheOmniGlow,+5,15,18,45%,33,2023/04/15
1826,909,,XNNS,-1,32,40,44%,72,2023/04/16
1827,909,,Mr. Herp,-2,14,19,42%,33,2023/04/16
1828,909,,Margo,+1,6,9,40%,15,2023/03/29
1829,908,,westonius,-5,13,19,41%,32,2023/04/01
1830,908,,triplewhit,-2,2,8,20%,10,2023/04/11
1831,908,,he565,+1,46,49,48%,95,2023/04/16
1832,908,,`Sury.,+4,11,12,48%,23,2023/04/06
1833,907,,Groooooo,+2,56,64,47%,120,2023/04/16
1834,907,,Willie2K,-2,8,11,42%,19,2023/03/24
1835,907,,OneOneSeven,+1,3,8,27%,11,2023/03/26
1836,906,,RoosterJuice,+1,32,33,49%,65,2023/03/22
1837,906,,Papercut_GR,-3,42,49,46%,91,2023/04/16
1838,906,,Niloc,-2,4,7,36%,11,2023/04/07
1839,906,,Ezio,-2,4,8,33%,12,2023/04/14
1840,906,,Goose,+2,11,18,38%,29,2023/03/23
1841,906,,JKimmawasp,-1,56,57,50%,113,2023/04/16
1842,905,,Admiral Piett,-1,30,33,48%,63,2023/04/16
1843,905,,Ttottik,-1,41,52,44%,93,2023/04/15
1844,905,,ExNihilo,-3,6,11,35%,17,2023/04/02
1845,905,,Randy Gordon,-1,5,7,42%,12,2023/04/07
1846,905,,Manhut^^ |JC| ‚Ñ¢,-7,47,50,48%,97,2023/04/17
1847,905,,Chunk / Zykxx,+2,14,18,44%,32,2023/03/31
1848,904,,barabinni,+2,5,8,38%,13,2023/04/16
1849,904,,Bootyquake,-1,19,26,42%,45,2023/04/16
1850,904,,Sidereh,+2,14,17,45%,31,2023/04/07
1851,903,,Snopel,-1,7,10,41%,17,2023/03/24
1852,903,,TwiddleCZ,-1,7,9,44%,16,2023/03/31
1853,902,,Reb0rN,-1,50,54,48%,104,2023/03/31
1854,902,,Imperator Thrax,-1,10,17,37%,27,2023/03/31
1855,902,,Koof,+1,21,26,45%,47,2023/03/25
1856,900,,Joe34,+1,4,7,36%,11,2023/04/16
1857,900,,Schach,+1,9,14,39%,23,2023/04/11
1858,900,,CaptainACE,+1,17,22,44%,39,2023/04/02
1859,900,,Jack The Stripper,-1,7,11,39%,18,2023/04/08
1860,900,,wenjen,-1,7,9,44%,16,2023/03/31
1861,899,,Ghost-link1,+5,13,15,46%,28,2023/04/04
1862,899,,david,-3,58,71,45%,129,2023/03/28
1863,899,,Bushes of Love,-2,7,11,39%,18,2023/03/21
1864,899,,UncleJoe,+2,6,9,40%,15,2023/04/17
1865,899,,Agent xWD40x,-2,5,8,38%,13,2023/04/12
1866,898,,anything is nothing,-1,46,53,46%,99,2023/04/16
1867,898,,AbacusFinch8060,-1,13,17,43%,30,2023/03/23
1868,897,,huntermyy,-2,12,17,41%,29,2023/03/23
1869,897,,Hellnubis,-1,12,15,44%,27,2023/04/14
1870,897,,Spartacus,-2,7,9,44%,16,2023/03/25
1871,897,,TheHappyGinger,-2,26,42,38%,68,2023/04/16
1872,897,,AzimutTheUt,-2,5,11,31%,16,2023/04/11
1873,896,,GRINDKING,-8,60,67,47%,127,2023/04/16
1874,896,,HawkslyTW,-1,9,13,41%,22,2023/04/16
1875,896,,Fidel Cashflow,-1,4,7,36%,11,2023/04/18
1876,896,,theevilboiler,-1,6,9,40%,15,2023/04/10
1877,896,,Saga,+1,34,41,45%,75,2023/04/17
1878,895,,Pwned2Much,-3,26,30,46%,56,2023/04/16
1879,895,,El Chupicabra,-4,10,15,40%,25,2023/04/13
1880,895,,NormlWater,-1,19,26,42%,45,2023/04/11
1881,895,,Sacro,+2,34,38,47%,72,2023/04/16
1882,894,,Jay2smooth,+2,9,13,41%,22,2023/04/07
1883,894,,Ciper,+2,11,16,41%,27,2023/04/14
1884,894,,DeGurk,-2,6,9,40%,15,2023/04/04
1885,894,,---^^^ O ‚ô• O ^^^---,-1,4,7,36%,11,2023/03/23
1886,894,,496E76616C6964537472696E67,-1,10,12,45%,22,2023/03/26
1887,894,,LeshDoodle,-1,5,8,38%,13,2023/04/12
1888,893,,SlayerY,+3,16,19,46%,35,2023/04/15
1889,893,,Spartacus,-1,16,20,44%,36,2023/03/31
1890,892,,Plum,-1,5,9,36%,14,2023/04/14
1891,892,,RandomScrub,-2,22,29,43%,51,2023/04/02
1892,892,,ar.sachango,-1,33,46,42%,79,2023/04/17
1893,892,,did0_13,+2,13,18,42%,31,2023/04/16
1894,892,,JDFJASJ1377,+2,19,27,41%,46,2023/04/17
1895,891,,SomeoneSomewhereDoingSomething,+1,12,18,40%,30,2023/04/11
1896,891,,McCurtis,+1,17,26,40%,43,2023/04/01
1897,891,,A 400lb Genetic Freak,-1,18,23,44%,41,2023/03/24
1898,891,,MARCO,+1,33,51,39%,84,2023/04/17
1899,890,,Meat Poop,-2,5,9,36%,14,2023/04/12
1900,890,,Gilhooley,+3,43,50,46%,93,2023/03/23
1901,890,,Nemesis,+2,9,17,35%,26,2023/03/21
1902,889,,Jeep,+3,44,68,39%,112,2023/04/17
1903,889,,Godless,-2,6,8,43%,14,2023/04/13
1904,889,,MillieTaint,-5,3,7,30%,10,2023/04/13
1905,889,,Peterparker69,-1,5,8,38%,13,2023/04/07
1906,889,,Clouded Mirror,-6,4,9,31%,13,2023/03/31
1907,888,,TotalRudeboy,-2,12,18,40%,30,2023/04/04
1908,888,,GinFitzGerald,-4,4,12,25%,16,2023/03/25
1909,888,,Greed,-3,5,10,33%,15,2023/03/27
1910,888,,BakUpBih,+1,3,7,30%,10,2023/04/11
1911,887,,CorruptCornflake,+1,29,37,44%,66,2023/04/17
1912,886,,sleeping_dude,-3,3,8,27%,11,2023/04/10
1913,886,,Caramez,+1,6,9,40%,15,2023/04/15
1914,886,,6LE6ION6,-4,3,7,30%,10,2023/04/01
1915,886,,Marmalade,-6,20,25,44%,45,2023/04/17
1916,886,,timezzzz,+1,5,8,38%,13,2023/04/10
1917,886,,Stark,+3,9,12,43%,21,2023/04/08
1918,886,,Toniii,+1,5,8,38%,13,2023/04/16
1919,886,,315oklopna,+2,16,20,44%,36,2023/04/15
1920,885,,chigundo,-5,5,11,31%,16,2023/04/01
1921,885,,MR6P_COH2,-4,82,101,45%,183,2023/04/16
1922,884,,Dirty Moses,-3,21,27,44%,48,2023/04/12
1923,884,,raatemsholosti,-2,21,32,40%,53,2023/04/17
1924,884,,NorCalRoach,-3,13,20,39%,33,2023/04/13
1925,884,,KidSoloDolo,-1,41,50,45%,91,2023/03/26
1926,883,,PWNZISCHEME,-3,17,20,46%,37,2023/04/17
1927,882,,Wiggom,-5,4,9,31%,13,2023/04/02
1928,882,,COMRADE PUTIN,-4,24,36,40%,60,2023/04/12
1929,882,,Nevosi,+1,3,7,30%,10,2023/04/02
1930,882,,HMS Renown,+1,6,10,38%,16,2023/03/29
1931,881,,OdinsChosen,-7,3,7,30%,10,2023/03/26
1932,881,,‚ô† Gauren ‚ô†,+1,13,15,46%,28,2023/04/03
1933,881,,[LUE]l2zack,-1,6,9,40%,15,2023/03/21
1934,881,,simonlii,+2,3,8,27%,11,2023/04/12
1935,881,,Êó†‰∫∫Ê∞∏Áîü,-3,8,14,36%,22,2023/04/15
1936,880,,Aspy008,-6,7,13,35%,20,2023/03/28
1937,880,,Bobsuruncle,+2,32,47,41%,79,2023/04/16
1938,880,,sprexnico,-1,7,13,35%,20,2023/04/07
1939,879,,Steven Stone,-5,21,32,40%,53,2023/04/15
1940,879,,shobbs001,-6,13,21,38%,34,2023/04/05
1941,879,,‚òº Astinus ‚òº,-3,8,11,42%,19,2023/04/14
1942,879,,Svenarchy,-4,6,11,35%,17,2023/03/24
1943,878,,zoltan.horvath14,-4,5,10,33%,15,2023/04/05
1944,878,,ToutchyHutchy,+1,5,10,33%,15,2023/04/17
1945,878,,smashboi1984,-1,89,113,44%,202,2023/04/08
1946,878,,David The Maverick,+1,24,32,43%,56,2023/04/16
1947,878,,-TiTlEy'S FuRy-,-3,5,13,28%,18,2023/04/14
1948,877,,HZB,+4,7,11,39%,18,2023/04/12
1949,877,,BMac,-1,5,8,38%,13,2023/04/01
1950,877,,jambomir,-1,4,8,33%,12,2023/04/14
1951,877,,chuaijun4,-4,18,23,44%,41,2023/03/24
1952,877,,jamesbreean,-1,49,63,44%,112,2023/04/08
1953,876,,drewholland1,+1,2,8,20%,10,2023/04/05
1954,876,,The Count,-5,42,50,46%,92,2023/04/11
1955,876,,Winter,-4,5,9,36%,14,2023/04/17
1956,876,,Gatau,-3,7,13,35%,20,2023/04/07
1957,876,,[CoBrA] Shadow*,-2,6,11,35%,17,2023/04/09
1958,876,,GameKing,+1,4,9,31%,13,2023/04/13
1959,875,,ZeroFuqsGiven,-3,20,26,43%,46,2023/04/15
1960,875,,Papi Long Legs,-2,4,9,31%,13,2023/04/10
1961,875,,KevlarTax,-1,6,13,32%,19,2023/04/18
1962,875,,Dr. Colossus,-2,41,58,41%,99,2023/04/17
1963,874,,yoyoyo,+2,41,51,45%,92,2023/03/27
1964,874,,Clone4082,-4,11,16,41%,27,2023/04/17
1965,874,,thorvaldmjolnir,-3,4,9,31%,13,2023/03/31
1966,874,,Tipper,+1,3,7,30%,10,2023/04/14
1967,873,,Joy-Energiser,+2,3,7,30%,10,2023/03/27
1968,873,,Sgt_Donny_Donnowitz,+2,28,37,43%,65,2023/04/17
1969,872,,worry.,+2,17,24,41%,41,2023/04/17
1970,872,,Stopgap,+1,3,8,27%,11,2023/03/25
1971,871,,Qmo,-2,8,20,29%,28,2023/04/04
1972,871,,Gaunt,-8,21,28,43%,49,2023/03/23
1973,871,,ArjenDissonance,-6,3,10,23%,13,2023/04/17
1974,871,,SoLo TB,+4,42,54,44%,96,2023/04/16
1975,870,,YYY_ËøëÊàòÊ≥ïÂ∏àÂàòÊµ∑Êü±,+1,23,32,42%,55,2023/04/12
1976,870,,MEDDLE+FEEN,-2,68,78,47%,146,2023/04/10
1977,870,,luppy,+1,40,56,42%,96,2023/04/16
1978,870,,PlushBean,+2,12,19,39%,31,2023/04/01
1979,869,,Douyu_Êù®ËÅöËææ,-1,10,14,42%,24,2023/04/11
1980,869,,Asbes,-1,3,7,30%,10,2023/04/14
1981,869,,Alex,+1,4,7,36%,11,2023/03/22
1982,868,,pow4h,+1,7,10,41%,17,2023/03/31
1983,868,,Squashnose,-3,7,12,37%,19,2023/04/17
1984,868,,Cpt Freedom,+2,12,18,40%,30,2023/04/05
1985,867,,Reshala,-1,4,8,33%,12,2023/03/23
1986,867,,Pustynny junak,+7,8,11,42%,19,2023/04/01
1987,867,,Dire Wolf,-3,18,24,43%,42,2023/04/09
1988,867,,Billy,-3,26,33,44%,59,2023/04/16
1989,867,,ÈπÖÂ≤óÂ§ß‰æ†,-1,14,16,47%,30,2023/04/17
1990,866,,SALADIN,-1,13,19,41%,32,2023/04/17
1991,866,,Mamba,+3,12,21,36%,33,2023/04/10
1992,866,,TuXaviParteAbuelas,+1,7,11,39%,18,2023/03/24
1993,866,,Ëâ∫ÊúØ‰∏éÂùüÂ¢ì,+1,9,15,38%,24,2023/04/06
1994,866,,[BRO] Judged@d,+1,86,103,46%,189,2023/04/17
1995,865,,MIKEINDIA,-4,4,9,31%,13,2023/04/16
1996,865,,Roadkill,-2,20,25,44%,45,2023/04/07
1997,865,,Madblazer,-1,69,86,45%,155,2023/04/07
1998,865,,PantherNY,-5,4,9,31%,13,2023/03/29
1999,864,,Toguro,+3,39,68,36%,107,2023/04/17
2000,864,,DedGecko,+1,6,11,35%,17,2023/04/16
2001,863,,Jakub,+3,6,10,38%,16,2023/03/31
2002,863,,Ivy,+1,34,45,43%,79,2023/04/17
2003,863,,naongu,+1,26,39,40%,65,2023/04/17
2004,863,,Lichiz,+2,10,13,43%,23,2023/04/02
2005,863,,Bearly,-5,3,7,30%,10,2023/04/01
2006,861,,srubert83,-3,7,11,39%,18,2023/04/05
2007,861,,Gideon,-4,6,13,32%,19,2023/04/15
2008,860,,[ENG] Warpeace,-3,5,10,33%,15,2023/04/08
2009,860,,Lion Bomay√©,-2,12,22,35%,34,2023/04/11
2010,860,,Major R. Sole,-3,71,89,44%,160,2023/04/14
2011,859,,Meseeks_Destroys,-2,7,13,35%,20,2023/03/23
2012,859,,Dr TeaBaggins,-3,3,7,30%,10,2023/04/03
2013,859,,hofmn,-3,17,27,39%,44,2023/03/25
2014,859,,carterpking,+1,27,37,42%,64,2023/04/17
2015,859,,Patte,-2,29,34,46%,63,2023/04/07
2016,859,,Orbitals,-5,8,14,36%,22,2023/03/29
2017,859,,Tamburello,-2,91,107,46%,198,2023/04/17
2018,859,,Best2nd,+1,5,8,38%,13,2023/03/28
2019,858,,Maniac,-5,3,8,27%,11,2023/04/09
2020,858,,Meta warrioR,-1,62,83,43%,145,2023/04/16
2021,858,,phys,-3,10,15,40%,25,2023/03/27
2022,857,,alMonster69,-10,8,18,31%,26,2023/04/03
2023,857,,ted0203,-3,6,11,35%,17,2023/03/30
2024,857,,HiKids,-1,3,8,27%,11,2023/04/16
2025,857,,prazak,+1,11,22,33%,33,2023/04/17
2026,856,,dbot,+4,5,8,38%,13,2023/04/14
2027,856,,DIIIA,+1,3,8,27%,11,2023/04/17
2028,856,,DontKillMe,-1,9,14,39%,23,2023/04/16
2029,856,,ANDOGNNI,-1,28,36,44%,64,2023/03/22
2030,856,,Milaii,-4,2,9,18%,11,2023/04/13
2031,856,,Â∫îÊÄ•È£üÂìÅÊ¥æËíô,-1,20,28,42%,48,2023/03/21
2032,855,,matsieron,-1,6,10,38%,16,2023/04/12
2033,855,,Takodachi,-3,6,12,33%,18,2023/04/10
2034,855,,EvilCLown,-4,9,16,36%,25,2023/03/29
2035,854,,Azang0,-1,3,7,30%,10,2023/03/22
2036,854,,Wtx.Ranger17,-2,6,13,32%,19,2023/04/13
2037,854,,threepwood,-1,3,7,30%,10,2023/03/30
2038,854,,[xXx]AUT_Austria100%,+3,4,8,33%,12,2023/04/08
2039,853,,Shinkou,-4,6,15,29%,21,2023/03/29
2040,853,,Samchi,-3,24,36,40%,60,2023/04/17
2041,853,,ÊàëÂπ≤Êãâ‰∫ÜÔºå‰Ω†Âë¢Ôºü,-1,5,9,36%,14,2023/03/30
2042,853,,304532544,+6,19,29,40%,48,2023/04/11
2043,852,,Dbh,-1,22,31,42%,53,2023/03/27
2044,852,,Knox123,-4,80,104,43%,184,2023/04/18
2045,852,,michalhori,-1,20,24,45%,44,2023/04/15
2046,852,,chronno,-3,29,44,40%,73,2023/04/17
2047,852,,Jifster,+1,4,9,31%,13,2023/04/01
2048,851,,ciko,-3,2,8,20%,10,2023/03/26
2049,851,,fontinixxl,-2,2,8,20%,10,2023/04/16
2050,850,,TomDelonge,+1,27,36,43%,63,2023/04/15
2051,850,,kusi86,+1,32,42,43%,74,2023/04/10
2052,850,,BRUTAL ‚Ä† HORDE,+1,14,22,39%,36,2023/04/15
2053,850,,iBrez,-1,29,40,42%,69,2023/04/17
2054,850,,Spartans Attack,-5,32,54,37%,86,2023/04/16
2055,849,,Imelinave,+1,12,21,36%,33,2023/04/14
2056,849,,Leroy Putty,+1,18,29,38%,47,2023/04/17
2057,848,,Grover the Trash Hermit,+2,4,8,33%,12,2023/04/08
2058,848,,GeneralTso,-2,18,26,41%,44,2023/04/17
2059,848,,Wahuhi,-3,4,9,31%,13,2023/04/03
2060,847,,stephane,-1,24,30,44%,54,2023/04/16
2061,847,,kiler47,+1,3,7,30%,10,2023/04/11
2062,847,,Frantix,-3,5,12,29%,17,2023/04/16
2063,846,,ricardosilva5555,-3,4,9,31%,13,2023/04/07
2064,845,,Monday,-1,15,21,42%,36,2023/04/06
2065,845,,ddunn2,-5,4,11,27%,15,2023/03/24
2066,845,,AceyLease,-1,3,7,30%,10,2023/03/30
2067,845,,NuKaNaKa,-2,6,12,33%,18,2023/03/31
2068,845,,maxime1425,-4,11,15,42%,26,2023/04/10
2069,845,,obaum69,+1,8,12,40%,20,2023/04/11
2070,844,,Lycurgus,+6,11,12,48%,23,2023/03/22
2071,844,,El'Drazzle,-1,3,8,27%,11,2023/04/08
2072,843,,Sylver,-1,4,10,29%,14,2023/04/16
2073,843,,Michael,+2,10,17,37%,27,2023/04/16
2074,843,,Bragui,+1,5,10,33%,15,2023/03/29
2075,842,,VenomusV,-3,3,10,23%,13,2023/04/16
2076,842,,FlatE,+2,20,27,43%,47,2023/04/09
2077,841,,sno^,+1,5,10,33%,15,2023/03/23
2078,841,,TGS|Borealis,-1,6,11,35%,17,2023/04/12
2079,841,,Rev_6:8,+1,23,37,38%,60,2023/04/16
2080,840,,Beilnar,-3,9,20,31%,29,2023/04/06
2081,840,,ËúªËúìÈòüÈïø,-1,48,75,39%,123,2023/04/16
2082,840,,Lambshaker,+1,10,16,38%,26,2023/04/03
2083,840,,snickerdoodle,+2,88,106,45%,194,2023/04/12
2084,840,,Killercrab1065,+1,3,8,27%,11,2023/04/14
2085,839,,FF7Forever,-5,17,27,39%,44,2023/03/28
2086,839,,Big Gun ONE,-3,5,11,31%,16,2023/03/29
2087,838,,IPO,-2,13,18,42%,31,2023/03/21
2088,837,,dam8909,-2,8,14,36%,22,2023/03/22
2089,836,,MagicBlue,-2,15,26,37%,41,2023/04/11
2090,836,,Homer Simpson's Coffin,-4,10,17,37%,27,2023/04/17
2091,836,,csiga,-3,29,42,41%,71,2023/04/04
2092,836,,caxulito,-1,12,19,39%,31,2023/03/21
2093,835,,trisgun,-1,150,229,40%,379,2023/04/17
2094,835,,[qum] Demon King 0beron,+1,4,8,33%,12,2023/03/24
2095,835,,aiSca,-2,7,15,32%,22,2023/04/13
2096,835,,Steve Irwin,-6,6,15,29%,21,2023/03/30
2097,835,,misterbeige,-6,2,8,20%,10,2023/04/11
2098,834,,electro418,+1,11,19,37%,30,2023/04/06
2099,834,,Bebelin,-2,5,12,29%,17,2023/04/06
2100,834,,hentai is my passion,-8,3,8,27%,11,2023/04/12
2101,834,,UnderParr,-4,5,12,29%,17,2023/04/01
2102,833,,KrawallAndi,-1,19,27,41%,46,2023/03/31
2103,833,,CaptKirt,-3,3,8,27%,11,2023/04/17
2104,832,,kic_kac,+1,26,40,39%,66,2023/04/16
2105,832,,JackOfAll,-1,5,11,31%,16,2023/04/10
2106,831,,Jayker,-6,4,11,27%,15,2023/04/02
2107,831,,15319769609,-6,3,9,25%,12,2023/04/13
2108,831,,nathan_ohanlon,-1,6,12,33%,18,2023/04/04
2109,831,,dehuang,+1,4,8,33%,12,2023/04/05
2110,830,,ajpriv,-4,4,11,27%,15,2023/04/17
2111,830,,Ironclad,+1,5,14,26%,19,2023/04/06
2112,830,,J I N X,-5,13,19,41%,32,2023/03/21
2113,830,,VonFigo,-2,47,60,44%,107,2023/04/17
2114,828,,ModernAce,-3,3,8,27%,11,2023/04/17
2115,828,,;o,-4,6,13,32%,19,2023/03/31
2116,828,,GrumblingKingJ,-4,30,41,42%,71,2023/04/14
2117,828,,DonStatus87,-1,15,30,33%,45,2023/04/11
2118,828,,Hobofingers,+1,36,51,41%,87,2023/04/15
2119,827,,Lecker,-2,4,11,27%,15,2023/04/17
2120,827,,Global Traveler,+1,2,8,20%,10,2023/04/15
2121,827,,SL4MW4RR10R,-1,2,10,17%,12,2023/04/06
2122,826,,TOMAHAWK,-4,42,66,39%,108,2023/04/12
2123,826,,Silverbone18,+2,6,13,32%,19,2023/04/03
2124,825,,Texicant,-4,3,9,25%,12,2023/03/21
2125,824,,Ë≤ìË≤ìÂ•ΩÂìÅÂë≥,-2,4,9,31%,13,2023/03/30
2126,823,,2015044103,+2,8,15,35%,23,2023/04/15
2127,823,,szwarc89,-7,39,71,35%,110,2023/04/17
2128,823,,cristopherburga92,+3,8,13,38%,21,2023/03/24
2129,823,,ÁñØÁãÇÊ¢ÖË•ø,-1,21,30,41%,51,2023/04/03
2130,822,,FPA.Splinter,-3,2,8,20%,10,2023/04/10
2131,822,,BestyBallz,-2,19,36,35%,55,2023/04/17
2132,821,,Paradicus,+1,13,24,35%,37,2023/04/01
2133,820,,NotoriousLAB,+2,9,14,39%,23,2023/04/17
2134,820,,thornyshave2000,+1,3,9,25%,12,2023/03/25
2135,820,,Richter Belmont,-2,7,13,35%,20,2023/03/24
2136,820,,RealPatchAdams,-1,43,81,35%,124,2023/04/17
2137,820,,mosar,+1,23,34,40%,57,2023/04/09
2138,820,,Chucken McNiggets,-1,3,8,27%,11,2023/03/25
2139,819,,qxxs,+1,8,18,31%,26,2023/03/28
2140,819,,SuperC,+1,8,15,35%,23,2023/04/17
2141,819,,fanboy88,-2,13,19,41%,32,2023/04/17
2142,818,,Placebo,-5,13,23,36%,36,2023/04/02
2143,818,,lanceaguirre1,-2,23,38,38%,61,2023/04/17
2144,818,,HBApps,-4,6,12,33%,18,2023/03/27
2145,817,,MrMisrulent,-1,22,31,42%,53,2023/04/01
2146,817,,unkemptdirigible,-3,3,11,21%,14,2023/04/08
2147,817,,matoukap,-1,15,21,42%,36,2023/04/06
2148,816,,[JaJa] Rominet,-4,15,28,35%,43,2023/04/17
2149,816,,leomalin,-3,4,9,31%,13,2023/04/16
2150,815,,TheGreatPumpkin,+1,20,36,36%,56,2023/04/18
2151,815,,NoobMicro,-6,15,26,37%,41,2023/03/21
2152,815,,Rallosdrake,-4,2,8,20%,10,2023/04/08
2153,815,,Small Nipples,-1,7,14,33%,21,2023/03/21
2154,814,,A40degreeday,-6,26,34,43%,60,2023/04/12
2155,814,,captainbros,+1,8,14,36%,22,2023/04/15
2156,813,,Laibach,-5,33,47,41%,80,2023/04/08
2157,813,,Odin,+2,8,19,30%,27,2023/04/14
2158,813,,gregreed508,-2,17,26,40%,43,2023/04/16
2159,812,,kiwiwatchdog,-2,8,16,33%,24,2023/04/07
2160,812,,z333762,-1,5,17,23%,22,2023/03/24
2161,811,,dpilot1010,-1,2,8,20%,10,2023/04/06
2162,811,,EOSFSE2,-2,5,13,28%,18,2023/04/09
2163,811,,12sdfnv31,+2,6,13,32%,19,2023/04/15
2164,811,,314193543,-3,3,11,21%,14,2023/04/16
2165,810,,Gherkins,-1,14,25,36%,39,2023/04/17
2166,810,,Cpl. ShiftyPowers44,+1,11,22,33%,33,2023/04/04
2167,809,,Asiannman,+1,15,26,37%,41,2023/04/11
2168,809,,Nepho,-6,2,8,20%,10,2023/04/16
2169,809,,UnderYourBedNed,-2,7,11,39%,18,2023/03/30
2170,809,,kettenkrad 117,-2,4,10,29%,14,2023/04/16
2171,809,,Steven,-1,7,12,37%,19,2023/04/16
2172,809,,Winchester 2000,-2,28,49,36%,77,2023/04/17
2173,808,,1559792049,-3,2,9,18%,11,2023/04/16
2174,808,,josh27armstrong,-3,6,15,29%,21,2023/03/23
2175,808,,Rozboojnik,-4,5,14,26%,19,2023/04/17
2176,808,,7c6e8186,-2,3,10,23%,13,2023/04/12
2177,808,,Áõò‰∏ùÊ¥ûÁúüÂ•ΩÁé©,-2,10,18,36%,28,2023/04/05
2178,807,,Atarax,-1,5,11,31%,16,2023/04/17
2179,807,,BlueBerry,-2,4,10,29%,14,2023/03/21
2180,807,,+The Shieldmaiden+,-1,39,49,44%,88,2023/04/10
2181,806,,ls4david,+5,10,15,40%,25,2023/03/21
2182,805,,Thorin,+1,1,10,9%,11,2023/04/18
2183,805,,You got ÂåóÈÉ®Á≤Ω,-2,2,8,20%,10,2023/03/25
2184,803,,Papab√§r,-4,2,9,18%,11,2023/04/09
2185,803,,HIMenjoy,-3,5,13,28%,18,2023/03/21
2186,803,,JAMBON_EN_CROUTE,+1,5,11,31%,16,2023/04/15
2187,803,,Allawenchen,+1,8,14,36%,22,2023/03/27
2188,803,,N4rage,-6,2,10,17%,12,2023/03/25
2189,802,,Andy,-2,3,12,20%,15,2023/04/09
2190,802,,Lucky,-2,5,13,28%,18,2023/04/01
2191,801,,R√º Guerrero,-5,4,13,24%,17,2023/04/05
2192,800,,Soylent,-1,13,22,37%,35,2023/04/09
2193,800,,Aheaddig,-3,7,16,30%,23,2023/03/22
2194,799,,slightlyinspired,-4,4,11,27%,15,2023/04/17
2195,798,,Thread of Jobe,-3,4,9,31%,13,2023/04/14
2196,798,,Amazon,-2,2,8,20%,10,2023/03/22
2197,798,,Beefmaster2000,-7,5,20,20%,25,2023/04/13
2198,798,,Brother,-4,13,18,42%,31,2023/03/26
2199,797,,Olivetoto78,+2,7,12,37%,19,2023/04/16
2200,797,,fofo,+1,5,15,25%,20,2023/04/16
2201,797,,sean.m.cotter7,-1,12,20,38%,32,2023/04/13
2202,796,,Clopticon,-6,3,10,23%,13,2023/03/22
2203,796,,TheNuke2169,-2,6,14,30%,20,2023/03/29
2204,796,,ThatGuy,-6,5,14,26%,19,2023/04/13
2205,796,,skx0624,-1,2,9,18%,11,2023/04/16
2206,796,,dachengxiaoyi,-4,5,11,31%,16,2023/03/28
2207,795,,Skr13,-4,4,13,24%,17,2023/04/17
2208,795,,kaczq4,+2,3,9,25%,12,2023/04/16
2209,795,,be4rd3d_s4murai,-6,9,18,33%,27,2023/03/22
2210,795,,kkaczmarek23,-1,3,8,27%,11,2023/04/10
2211,795,,Wodan,-1,3,10,23%,13,2023/04/16
2212,794,,ottomanslap,-4,3,9,25%,12,2023/03/24
2213,794,,stickrouse,-1,7,17,29%,24,2023/03/21
2214,794,,Stanghellini,-1,9,19,32%,28,2023/04/16
2215,793,,SteezyCamz,-2,2,9,18%,11,2023/03/21
2216,793,,azur,-3,5,13,28%,18,2023/04/16
2217,792,,Infidel,-2,10,21,32%,31,2023/03/21
2218,791,,bpeace04,+1,4,11,27%,15,2023/04/15
2219,790,,Osrin,-7,3,10,23%,13,2023/04/09
2220,790,,DJ Misha,-2,14,22,39%,36,2023/04/17
2221,789,,Nessman59,-2,12,18,40%,30,2023/03/27
2222,789,,Uzii57,-1,2,14,13%,16,2023/04/09
2223,789,,Mountainman,+1,39,83,32%,122,2023/04/17
2224,789,,orangecrushhog,+1,49,64,43%,113,2023/03/21
2225,788,,D-Ro¬¢k96,-2,12,22,35%,34,2023/03/29
2226,788,,opticalfalicy,-2,22,36,38%,58,2023/04/17
2227,788,,anjunaebs,-1,2,8,20%,10,2023/04/09
2228,788,,totallyfrom,-3,4,11,27%,15,2023/03/21
2229,787,,twitchtvflekz127,-3,8,16,33%,24,2023/04/16
2230,787,,BRIGEI,-7,2,8,20%,10,2023/04/08
2231,787,,Spicy McHaggis,+1,5,13,28%,18,2023/04/12
2232,787,,Dartti,-1,5,11,31%,16,2023/04/11
2233,786,,cruelaflood,-2,7,17,29%,24,2023/04/08
2234,786,,murlocmarine,+1,8,15,35%,23,2023/04/12
2235,784,,schorx_laplant,-2,5,16,24%,21,2023/04/17
2236,784,,educastillospain,-3,4,11,27%,15,2023/04/08
2237,784,,pablogarcia.perc,+2,6,15,29%,21,2023/04/13
2238,784,,Micksen,-3,4,14,22%,18,2023/04/11
2239,783,,Highwaylord,+2,5,16,24%,21,2023/04/15
2240,783,,Salami Lid,-1,38,55,41%,93,2023/03/30
2241,782,,baemberock,-1,27,49,36%,76,2023/04/01
2242,782,,SeeRad,+1,3,8,27%,11,2023/04/16
2243,782,,Supersmash,-1,3,11,21%,14,2023/04/17
2244,782,,SamuraiKIN,-1,2,8,20%,10,2023/04/12
2245,782,,HeavyKevy,-2,9,17,35%,26,2023/04/10
2246,781,,Wardfish,-1,7,15,32%,22,2023/04/17
2247,781,,KackTheTripper,-9,4,14,22%,18,2023/04/09
2248,781,,hypersonyk,-2,59,98,38%,157,2023/04/13
2249,780,,006Horst_der_echte,-4,2,8,20%,10,2023/04/17
2250,780,,Mightymoff,-1,18,40,31%,58,2023/04/15
2251,779,,Killshot-NL,-1,7,16,30%,23,2023/04/01
2252,779,,kamolapob01,-1,10,22,31%,32,2023/04/02
2253,779,,General Dakrade,-1,13,21,38%,34,2023/04/15
2254,778,,Sardino,-3,3,11,21%,14,2023/04/06
2255,778,,Scanline City,-1,3,12,20%,15,2023/04/17
2256,777,,MeggaM,-2,49,78,39%,127,2023/04/17
2257,777,,African Charlie Brown,+3,5,10,33%,15,2023/03/27
2258,777,,Strubus,+1,5,12,29%,17,2023/04/16
2259,777,,HerbthePerv,-2,3,10,23%,13,2023/04/16
2260,777,,LOLwhat2,-2,7,18,28%,25,2023/03/22
2261,777,,liptak,+1,12,25,32%,37,2023/04/16
2262,777,,Thibonx,-3,3,10,23%,13,2023/03/31
2263,776,,Smellon,-5,3,10,23%,13,2023/04/12
2264,776,,emilcirineo10,-2,2,8,20%,10,2023/03/24
2265,775,,eudoux,-4,7,16,30%,23,2023/04/15
2266,775,,.ride,-2,13,24,35%,37,2023/04/01
2267,773,,Juv3y,-3,9,21,30%,30,2023/04/01
2268,773,,k1036666,-5,2,10,17%,12,2023/04/15
2269,773,,xDragon970,-8,2,11,15%,13,2023/03/26
2270,772,,Diogenes the Dog,-1,3,10,23%,13,2023/04/01
2271,772,,Devil,+1,11,23,32%,34,2023/03/30
2272,772,,thenelson,+2,16,32,33%,48,2023/04/17
2273,771,,Mega_Matt,-3,10,21,32%,31,2023/04/07
2274,771,,DaveStone,-1,4,13,24%,17,2023/04/08
2275,771,,Mr.Black (FR),-1,2,8,20%,10,2023/04/12
2276,771,,Huda,+1,40,69,37%,109,2023/04/06
2277,770,,Patrik,+1,5,12,29%,17,2023/04/15
2278,770,,KAPSCOOPER,-8,2,9,18%,11,2023/03/28
2279,768,,BETTERRUNSON,-3,3,12,20%,15,2023/03/30
2280,767,,darkdepth,-2,67,112,37%,179,2023/04/17
2281,766,,Highbob,-1,4,10,29%,14,2023/04/01
2282,765,,Outsider,-3,7,16,30%,23,2023/04/16
2283,765,,Benjad,+2,4,10,29%,14,2023/03/30
2284,765,,Erni,-10,2,10,17%,12,2023/03/21
2285,765,,Charon,-12,6,17,26%,23,2023/04/03
2286,765,,ARMAGEDDON_BETWEENER,+1,3,10,23%,13,2023/04/10
2287,764,,DirtyOH,+1,3,7,30%,10,2023/04/07
2288,764,,Orano,-2,7,17,29%,24,2023/04/13
2289,763,,‚ò† Archer ‚öÖ,-2,6,14,30%,20,2023/03/30
2290,763,,whothefock,+1,33,57,37%,90,2023/04/16
2291,763,,capitaine.Nemo,-3,5,13,28%,18,2023/04/12
2292,762,,wckgg_87429656,-6,7,17,29%,24,2023/04/07
2293,762,,Taterbait,-13,10,25,29%,35,2023/03/23
2294,761,,2114751070,+4,9,16,36%,25,2023/03/22
2295,761,,MrOverall99,-1,5,13,28%,18,2023/03/27
2296,760,,hicrew_187,+1,19,32,37%,51,2023/03/30
2297,760,,Bewmur,-2,19,34,36%,53,2023/04/12
2298,759,,Allied Mastercomputer,-2,7,19,27%,26,2023/04/17
2299,759,,holy_kiwi,+2,4,14,22%,18,2023/04/10
2300,759,,RvsS,+1,3,9,25%,12,2023/04/09
2301,758,,mtsouth78,-6,2,13,13%,15,2023/04/17
2302,758,,Hevy,-1,4,20,17%,24,2023/03/24
2303,756,,dannybagz,-8,3,18,14%,21,2023/04/07
2304,755,,Vapes 4 Christ,+2,10,25,29%,35,2023/04/17
2305,755,,khk6787,-9,1,9,10%,10,2023/04/02
2306,755,,Chandler444,+2,2,9,18%,11,2023/04/16
2307,754,,MIDO,-1,3,11,21%,14,2023/04/02
2308,754,,MENTALLY ILL LIL SQUARE BUB,-5,14,24,37%,38,2023/04/11
2309,752,,Soapp5,+1,6,16,27%,22,2023/04/02
2310,752,,LeGrillePain,-1,52,98,35%,150,2023/04/18
2311,752,,MadBrowdy,-2,2,9,18%,11,2023/04/15
2312,752,,Mr Black_Way,-4,11,21,34%,32,2023/04/06
2313,752,,AthaGeoGR,+1,2,10,17%,12,2023/03/25
2314,751,,dsbh85,+1,3,11,21%,14,2023/03/27
2315,750,,Yunocrates,+3,5,13,28%,18,2023/04/13
2316,750,,LilHank,+1,2,9,18%,11,2023/04/08
2317,750,,isaif77,+1,5,14,26%,19,2023/04/13
2318,750,,Miczelo,-4,4,21,16%,25,2023/04/17
2319,749,,bboymac,+1,1,9,10%,10,2023/04/01
2320,749,,Cpt.Dankey,-1,5,11,31%,16,2023/04/17
2321,748,,vktm,-3,4,10,29%,14,2023/03/24
2322,748,,$zczuto,-7,1,9,10%,10,2023/04/14
2323,748,,LlorchDurden,-3,42,73,37%,115,2023/04/16
2324,748,,BorkedUK,-1,3,14,18%,17,2023/03/29
2325,747,,RamireZ ^O^,-13,0,13,0%,13,2023/04/13
2326,746,,TIGnDABS_007,-5,2,10,17%,12,2023/04/14
2327,745,,DR.honzo,-1,30,67,31%,97,2023/04/17
2328,745,,Markus,-1,4,13,24%,17,2023/04/17
2329,744,,Logan,-1,13,25,34%,38,2023/04/02
2330,744,,Ashtray IX,-3,5,16,24%,21,2023/03/30
2331,743,,ApolloFarstriker,-4,7,27,21%,34,2023/04/02
2332,742,,pierrot chapo,-10,2,12,14%,14,2023/04/10
2333,742,,Eli,-5,79,119,40%,198,2023/04/06
2334,741,,ChevyDad,-2,4,12,25%,16,2023/04/09
2335,740,,S1LETAP,-1,5,14,26%,19,2023/04/17
2336,740,,HistoriK,+1,36,64,36%,100,2023/04/16
2337,739,,mschaneman,-2,11,19,37%,30,2023/03/29
2338,739,,seabassf,-8,1,9,10%,10,2023/04/03
2339,739,,DovyTheHammer,-5,3,11,21%,14,2023/04/16
2340,738,,Magic,-3,6,17,26%,23,2023/04/05
2341,738,,Zrno87,-2,1,9,10%,10,2023/04/06
2342,738,,Aimless,-7,2,12,14%,14,2023/04/07
2343,738,,TyphoonKicks,-2,8,16,33%,24,2023/03/21
2344,738,,AirmanApostle,-7,2,10,17%,12,2023/03/31
2345,737,,connor18,-1,8,20,29%,28,2023/04/04
2346,735,,harunars_13,+1,23,52,31%,75,2023/04/17
2347,735,,Finn,-3,3,13,19%,16,2023/03/22
2348,734,,nickevans973,-2,6,16,27%,22,2023/04/07
2349,734,,Davidkik222,-3,1,9,10%,10,2023/03/25
2350,734,,Redeemer333,+3,6,22,21%,28,2023/04/16
2351,733,,Date Mike,-3,1,9,10%,10,2023/04/01
2352,732,,filda,-2,3,13,19%,16,2023/04/17
2353,732,,930328284,-4,3,11,21%,14,2023/04/11
2354,731,,Alien,+1,4,19,17%,23,2023/04/04
2355,730,,Naegele,-11,34,47,42%,81,2023/04/03
2356,728,,EMajorero22,-3,3,11,21%,14,2023/04/16
2357,728,,Maleven,-1,17,41,29%,58,2023/04/17
2358,727,,MildWombat,-8,5,16,24%,21,2023/04/08
2359,727,,Jordano2204,+1,8,16,33%,24,2023/03/31
2360,726,,lbtym8311,-3,2,11,15%,13,2023/04/05
2361,726,,Spontaneous,-5,6,22,21%,28,2023/04/17
2362,725,,ttvarlequin,-4,1,9,10%,10,2023/04/05
2363,724,,A-kade47,-5,3,15,17%,18,2023/04/14
2364,724,,Greed,+1,3,12,20%,15,2023/04/04
2365,723,,frazyrgaming,-1,4,16,20%,20,2023/04/16
2366,722,,freeman248xz,-6,22,57,28%,79,2023/04/15
2367,720,,GEARCO,+2,18,41,31%,59,2023/04/16
2368,720,,maneats2live,-1,34,68,33%,102,2023/04/17
2369,719,,epablog,-3,8,27,23%,35,2023/03/29
2370,719,,a715997,-8,1,10,9%,11,2023/04/17
2371,719,,huchen0103,-5,9,23,28%,32,2023/03/24
2372,719,,Private_Pistolero,-1,2,12,14%,14,2023/03/21
2373,719,,Quirinius,-4,8,24,25%,32,2023/04/06
2374,718,,YoDonkey,-13,32,50,39%,82,2023/04/11
2375,718,,ÂØ∫Â∑ùÁà±Áæé,+1,1,9,10%,10,2023/04/15
2376,718,,MiniShark,-4,1,11,8%,12,2023/04/14
2377,717,,z.iec53,+1,1,10,9%,11,2023/04/12
2378,715,,SayMyName,-10,0,10,0%,10,2023/04/05
2379,715,,aaaDARKxVOID,-2,9,22,29%,31,2023/04/15
2380,713,,24,-1,9,34,21%,43,2023/04/17
2381,713,,Tombs,-4,1,9,10%,10,2023/04/14
2382,712,,S0N 0F N0THING,-2,2,11,15%,13,2023/04/08
2383,712,,Dishhonored,-5,5,25,17%,30,2023/04/14
2384,712,,miralds,+1,2,15,12%,17,2023/03/31
2385,712,,chriesp,-1,2,13,13%,15,2023/04/14
2386,711,,molotov,-4,2,9,18%,11,2023/04/05
2387,711,,bigy,-3,4,20,17%,24,2023/04/18
2388,711,,ggusakan,-8,1,10,9%,11,2023/04/14
2389,710,,397272537,-11,0,11,0%,11,2023/04/03
2390,710,,Hasthur,-2,2,11,15%,13,2023/04/13
2391,709,,SoftcorE,-1,19,41,32%,60,2023/04/07
2392,708,,wilfredo967,-6,56,88,39%,144,2023/04/09
2393,706,,Bushleague,-3,4,13,24%,17,2023/03/25
2394,706,,James Bond,-8,5,16,24%,21,2023/03/31
2395,706,,MrTeej2,+1,22,54,29%,76,2023/04/11
2396,706,,Wu Wei,-1,20,40,33%,60,2023/04/03
2397,705,,Goulash,+1,25,60,29%,85,2023/04/18
2398,705,,maiktreichel1967,+2,45,87,34%,132,2023/03/25
2399,705,,MasterMind,-3,2,11,15%,13,2023/03/21
2400,704,,Noobie Noobinston,-2,49,96,34%,145,2023/04/18
2401,704,,exsap,-12,2,15,12%,17,2023/04/10
2402,703,,Haivan024,-8,11,30,27%,41,2023/04/12
2403,703,,MajorTeaman,-3,3,14,18%,17,2023/04/04
2404,703,,AndyMVA96,-5,1,9,10%,10,2023/03/28
2405,702,,DaddyCobra,-3,17,43,28%,60,2023/04/18
2406,700,,cdp3,-10,0,10,0%,10,2023/03/23
2407,699,,torkel2811,+1,27,61,31%,88,2023/04/17
2408,698,,Veeh Youtube,-1,31,62,33%,93,2023/04/14
2409,698,,clarkgent,+2,16,33,33%,49,2023/04/18
2410,698,,Errorien,-4,2,12,14%,14,2023/04/02
2411,698,,architroop,+1,3,12,20%,15,2023/03/30
2412,696,,[YHG]TLK,-2,2,13,13%,15,2023/03/29
2413,696,,kornev86,-2,6,16,27%,22,2023/04/16
2414,695,,ligerinho(BR),+2,16,40,29%,56,2023/04/17
2415,695,,TupacIsAlive,+1,8,29,22%,37,2023/04/07
2416,693,,Parham PZ,+1,1,9,10%,10,2023/04/15
2417,693,,goldenbeagle2006,-8,2,17,11%,19,2023/04/10
2418,691,,jjsin420,-2,8,18,31%,26,2023/04/03
2419,689,,m0t0r,+2,6,17,26%,23,2023/04/16
2420,688,,grungos666,-1,2,12,14%,14,2023/04/17
2421,687,,Ishgama,-2,4,14,22%,18,2023/04/14
2422,687,,PrinceGoro,+1,61,109,36%,170,2023/04/17
2423,686,,ljlconsulting,-6,1,13,7%,14,2023/03/26
2424,685,,Shunkiz *TanKKK*,-3,12,28,30%,40,2023/04/12
2425,685,,Burn3y3,-2,12,36,25%,48,2023/04/06
2426,683,,frederic.biedak,-10,0,10,0%,10,2023/04/17
2427,682,,Biggie,-4,9,27,25%,36,2023/03/30
2428,681,,FuzzyDunlop81,-4,8,27,23%,35,2023/04/01
2429,680,,vinnorici,-8,1,9,10%,10,2023/04/13
2430,680,,Legion,-4,21,39,35%,60,2023/04/17
2431,679,,d4b,+1,9,34,21%,43,2023/04/14
2432,679,,Zonk,-5,8,28,22%,36,2023/04/17
2433,679,,SavageSageon,-1,5,14,26%,19,2023/03/26
2434,678,,‰∏É‰∏™Ëë´Ëä¶Â®É,+2,4,13,24%,17,2023/04/06
2435,678,,pabloocontreras13,-2,1,11,8%,12,2023/04/06
2436,678,,Ê¨ßÁ•û‰ªô,-3,3,15,17%,18,2023/04/17
2437,676,,Manicdemon,-6,1,12,8%,13,2023/04/08
2438,675,,NEILO-LTC,+1,7,25,22%,32,2023/03/26
2439,675,,Fritz,-2,1,12,8%,13,2023/04/02
2440,674,,windonet,-3,37,75,33%,112,2023/04/16
2441,672,,HEX: LeGacy,+1,2,14,13%,16,2023/04/07
2442,670,,Imam lud da sam papir‚Ñ¢,-6,5,22,19%,27,2023/04/13
2443,669,,lozadajose927,-8,38,109,26%,147,2023/04/17
2444,669,,707539654,+1,5,23,18%,28,2023/04/16
2445,667,,Burk,-16,0,16,0%,16,2023/04/05
2446,665,,caiusgracchus,-7,3,16,16%,19,2023/03/30
2447,665,,Dilirium le ch'ti,-15,17,47,27%,64,2023/04/17
2448,664,,Reaper,-11,0,11,0%,11,2023/04/14
2449,663,,carlfish20,-7,6,25,19%,31,2023/04/15
2450,662,,ARMENIAN94,-4,2,13,13%,15,2023/04/01
2451,661,,third,-10,0,10,0%,10,2023/04/16
2452,659,,mariodavidreg89,-15,0,15,0%,15,2023/04/17
2453,659,,Pdro,-8,4,19,17%,23,2023/04/15
2454,658,,EndState,-6,1,12,8%,13,2023/03/31
2455,658,,alphablue32,-2,7,40,15%,47,2023/04/18
2456,657,,herbhurst.ia,-14,23,61,27%,84,2023/04/13
2457,655,,Powertime,-13,0,13,0%,13,2023/03/21
2458,655,,hatsunemiku,-4,4,19,17%,23,2023/04/16
2459,653,,quentin.dlh,-3,3,20,13%,23,2023/04/17
2460,652,,BIG Barnhart,-14,0,14,0%,14,2023/04/04
2461,652,,mkjin85,+1,6,27,18%,33,2023/04/16
2462,650,,Z3ffyR,-10,0,10,0%,10,2023/04/11
2463,649,,fiveop.cc,-16,3,27,10%,30,2023/04/11
2464,647,,mr upprcut,-8,3,19,14%,22,2023/04/01
2465,643,,KmSle,-2,5,26,16%,31,2023/04/14
2466,642,,Bowizzle4,-15,0,15,0%,15,2023/04/16
2467,642,,[DGM] mcfly02200 [FR],-1,10,34,23%,44,2023/04/14
2468,641,,GabeNeal27,-11,9,32,22%,41,2023/04/15
2469,640,,marcinlab,-12,0,12,0%,12,2023/03/28
2470,639,,sCoX,-2,13,37,26%,50,2023/04/16
2471,636,,AyyMegusta,-20,0,20,0%,20,2023/04/16
2472,635,,ktv,-11,2,25,7%,27,2023/04/18
2473,635,,eliasghaoui1998,+1,9,36,20%,45,2023/04/10
2474,633,,Â§öÂÖ∞‰πãÈ≠îÊ≥ïÂ∏à,-5,2,14,13%,16,2023/03/22
2475,628,,OnePak,-5,6,31,16%,37,2023/04/04
2476,625,,Diamond Hands,-5,2,21,9%,23,2023/04/12
2477,624,,lufrednuwrm,-3,7,37,16%,44,2023/04/12
2478,624,,kivar30,-5,3,19,14%,22,2023/03/22
2479,624,,nathanjeyhani,-7,1,13,7%,14,2023/04/14
2480,621,,[ITA]bombomosthated2702,-2,2,20,9%,22,2023/03/26
2481,620,,chris.shieh2020,-20,0,20,0%,20,2023/04/15
2482,616,,BooHags,-9,2,17,11%,19,2023/04/14
2483,615,,matigol72,-7,2,20,9%,22,2023/04/11
2484,615,,francois,-4,6,34,15%,40,2023/04/08
2485,612,,hawkeye,+1,3,20,13%,23,2023/04/11
2486,608,,bl4ckjack,-10,1,12,8%,13,2023/03/26
2487,607,,nuns323,-14,0,14,0%,14,2023/04/15
2488,607,,Eric852,-12,0,12,0%,12,2023/03/27
2489,606,,hate me,-10,0,10,0%,10,2023/04/16
2490,603,,DiDji_eMMe,-12,2,17,11%,19,2023/04/01
2491,603,,[MG] BulletDispenser,-5,15,41,27%,56,2023/03/24
2492,602,,dalmatica,-23,1,29,3%,30,2023/04/16
2493,600,,F4lc!,-5,4,30,12%,34,2023/04/09
2494,593,,maximedesimon,-13,0,13,0%,13,2023/03/29
2495,592,,Heythebelch,-2,5,30,14%,35,2023/04/17
2496,592,,SUPERB!!,-1,6,24,20%,30,2023/04/08
2497,588,,Jlga,-12,0,12,0%,12,2023/03/26
2498,584,,foolishfriend,-15,3,37,8%,40,2023/04/16
2499,579,,Tomy_CAT,+1,2,23,8%,25,2023/04/15
2500,576,,OnceAgain,-5,3,29,9%,32,2023/04/17
2501,574,,s0nny_50,-7,1,16,6%,17,2023/03/26
2502,569,,A.Brent,-12,0,12,0%,12,2023/04/03
2503,569,,SirOwnsAlot,-2,4,33,11%,37,2023/04/11
2504,566,,Áà±ÂøµÁóõ,-3,20,73,22%,93,2023/04/05
2505,565,,clackcalven,-11,2,26,7%,28,2023/04/15
2506,563,,Baker,-7,1,17,6%,18,2023/03/28
2507,562,,ricar_mertxe,-27,2,29,6%,31,2023/04/17
2508,554,,Brown Dirt Cowboy,-28,1,29,3%,30,2023/04/13
2509,548,,Spartacus,-16,0,16,0%,16,2023/04/12
2510,548,,Poundercakes,-8,2,18,10%,20,2023/04/03
2511,546,,HB_JOSH,-13,1,25,4%,26,2023/04/17
2512,530,,H.E.A.D.M.A.N,-21,0,21,0%,21,2023/03/29
2513,514,,kundernietsvan,-6,4,26,13%,30,2023/04/04
2514,511,,landy5,-13,2,29,6%,31,2023/04/16
2515,505,,ÂÆàÁåéËÄÖ01,-2,3,41,7%,44,2023/04/17
2516,488,,Ghost Army,-16,4,48,8%,52,2023/04/13
2517,481,,Triton II,-31,13,79,14%,92,2023/04/14
2518,460,,vautour10,-24,12,93,11%,105,2023/04/17
2519,414,,Trumpf,-42,0,42,0%,42,2023/03/29
