RANK,ELO,LEVEL,ALIAS,STREAK,WINS,LOSSES,RATIO,TOTAL,LAST GAME
1,1724,,Amita,+28,94,19,83%,113,2023/04/17
2,1640,,Jibber,+23,98,21,82%,119,2023/04/08
3,1595,,Rei,+7,80,14,85%,94,2023/03/31
4,1593,,elpern,-1,60,15,80%,75,2023/04/17
5,1583,,Theodosios,+2,41,7,85%,48,2023/04/16
6,1557,,Happycat,+22,58,16,78%,74,2023/04/17
7,1552,,havoc,+8,103,42,71%,145,2023/04/17
8,1548,,xFidde,+4,65,19,77%,84,2023/04/11
9,1546,,หลวงปู่เณร,+1,71,19,79%,90,2023/04/10
10,1545,,S205,-2,76,20,79%,96,2023/04/17
11,1526,,BrainSplat | HulkSMASH,+8,64,26,71%,90,2023/04/13
12,1526,,[Peanut] Caosak,+1,23,3,88%,26,2023/04/06
13,1519,,F3riG,+7,23,2,92%,25,2023/03/31
14,1519,,you can count on osttruppen!,+2,144,54,73%,198,2023/04/16
15,1508,,[L2P]BartonPL,+7,38,9,81%,47,2023/04/12
16,1506,,DumaisTV,-3,74,22,77%,96,2023/04/11
17,1506,,oziligath,+3,91,44,67%,135,2023/04/17
18,1503,,渣渣，反了他，偶不艹了你爸，气死偶嘞！！,-2,99,43,70%,142,2023/04/13
19,1502,,momo4sho,-1,47,15,76%,62,2023/04/15
20,1501,,Luvnest,+1,46,18,72%,64,2023/04/17
21,1484,,Frontyard man,-1,34,8,81%,42,2023/03/28
22,1479,,Miguel,+9,15,1,94%,16,2023/04/08
23,1479,,UMirinBrah?,+4,34,8,81%,42,2023/04/12
24,1474,,Jesus is My Saviour,+11,22,2,92%,24,2023/04/15
25,1469,,ashilrye,+8,37,12,76%,49,2023/04/17
26,1467,,Charlotte,+2,79,38,68%,117,2023/04/17
27,1467,,MajorKusaetNogi,+7,33,6,85%,39,2023/04/01
28,1466,,Trainzz,+9,105,56,65%,161,2023/04/11
29,1465,,星奏の女仆,+7,36,10,78%,46,2023/04/15
30,1463,,Mordo47,+2,23,5,82%,28,2023/04/13
31,1460,,Backyard man,+2,73,35,68%,108,2023/04/16
32,1458,,vwvc,-1,62,33,65%,95,2023/04/17
33,1458,,BaByuByu,+12,34,7,83%,41,2023/04/14
34,1457,,The Sloth,+3,70,32,69%,102,2023/04/01
35,1455,,老北京鸡肉卷OldBeijingChickenTwister,+16,81,54,60%,135,2023/04/04
36,1452,,Tiefflieger,+2,39,12,76%,51,2023/04/09
37,1451,,Siberian,+8,62,23,73%,85,2023/04/16
38,1451,,nub,+5,49,22,69%,71,2023/04/17
39,1450,,Jesulin,+3,22,6,79%,28,2023/04/13
40,1449,,Imperial Dane,+1,71,38,65%,109,2023/04/17
41,1449,,Mickey,-6,96,50,66%,146,2023/04/10
42,1447,,TarNationZ,+5,17,2,89%,19,2023/04/01
43,1439,,[GCDC]RwiAng,-2,33,13,72%,46,2023/03/25
44,1439,,PutPut - AusarTheVile,+2,62,23,73%,85,2023/04/17
45,1435,,Toiletguy,+5,76,35,68%,111,2023/04/16
46,1432,,Imperates,+15,55,28,66%,83,2023/03/30
47,1426,,Hanwoomul,-3,34,11,76%,45,2023/04/17
48,1425,,TheChosen,+5,65,30,68%,95,2023/04/05
49,1422,,[Peanut] Calyon,+12,27,5,84%,32,2023/04/04
50,1422,,Nicko,+1,26,6,81%,32,2023/04/13
51,1418,,CUBYX,+8,127,83,60%,210,2023/04/04
52,1417,,The101stAirBorne,-2,75,42,64%,117,2023/04/17
53,1417,,salmonTA,+6,46,25,65%,71,2023/04/17
54,1416,,[PAX Sqd.] PAX AJAX,-1,42,24,64%,66,2023/04/17
55,1416,,[EPIC]gogy,+2,103,57,64%,160,2023/04/16
56,1416,,Make a wish™ |,+2,35,18,66%,53,2023/04/15
57,1413,,a hell on earth,+15,45,16,74%,61,2023/04/09
58,1412,,Dumme Katze,+5,28,13,68%,41,2023/04/16
59,1405,,Chaos,+1,193,147,57%,340,2023/04/15
60,1404,,bibotot1995,-2,119,97,55%,216,2023/04/17
61,1401,,DaPopeCOH,+4,38,20,66%,58,2023/04/07
62,1399,,Aimstrong,-1,42,26,62%,68,2023/04/05
63,1399,,Imbbe,+1,41,20,67%,61,2023/04/09
64,1398,,lattouf,+4,23,7,77%,30,2023/04/17
65,1398,,JiuMi,+7,33,11,75%,44,2023/04/05
66,1395,,Riftwalker,+3,36,15,71%,51,2023/04/17
67,1395,,The Angry Dutchman,+6,40,16,71%,56,2023/04/14
68,1394,,FK9DD,+7,126,102,55%,228,2023/04/17
69,1392,,Equuz,+2,18,4,82%,22,2023/04/04
70,1392,,小芙丽娅,+3,64,33,66%,97,2023/04/16
71,1391,,night_raven0203,-1,32,15,68%,47,2023/04/06
72,1390,,PanzerGrenadier,+7,59,36,62%,95,2023/04/15
73,1390,,Jelly Bean,+1,33,13,72%,46,2023/04/11
74,1390,,DexN,+1,81,44,65%,125,2023/04/15
75,1387,,✠ Kaiser Friedrich ✠,-1,22,10,69%,32,2023/04/06
76,1386,,W00tLeLBrrrrrrrrrrrrrr,+4,27,7,79%,34,2023/04/18
77,1385,,포스트정윤종,+1,58,34,63%,92,2023/04/09
78,1384,,Inverse,+14,40,14,74%,54,2023/04/16
79,1382,,K. Ronaldo,+2,56,26,68%,82,2023/03/25
80,1380,,Dzindzu,-1,28,13,68%,41,2023/03/23
81,1379,,WordBearers[Borgore],+7,84,57,60%,141,2023/04/17
82,1378,,Luckeeey,+1,91,63,59%,154,2023/04/18
83,1374,,MightyMouseJHM,+4,30,10,75%,40,2023/04/18
84,1373,,PunisHer1638,+17,21,6,78%,27,2023/04/09
85,1373,,Kuun-Lan Kiith Somtaaw,+5,15,2,88%,17,2023/03/31
86,1373,,Leiarde,+4,47,26,64%,73,2023/04/14
87,1372,,sheenhochul,-3,166,102,62%,268,2023/04/17
88,1371,,Enemy,+3,62,41,60%,103,2023/04/17
89,1371,,vegetabledoge,-1,40,25,62%,65,2023/04/17
90,1367,,Clororaa,+1,10,1,91%,11,2023/03/30
91,1367,,Finndeed,+8,28,15,65%,43,2023/04/04
92,1366,,Estocade Gaming YT,+2,74,39,65%,113,2023/04/16
93,1365,,SOLID MATTIC,+4,97,74,57%,171,2023/04/17
94,1364,,fiadaputa,-1,89,61,59%,150,2023/04/18
95,1363,,Orangepest,+3,16,4,80%,20,2023/04/09
96,1362,,tagilla,+3,57,33,63%,90,2023/04/04
97,1360,,Outbalz the moon bunny,+4,25,10,71%,35,2023/04/09
98,1359,,MIRASSOL_БЕСЧЕСТНЫЙ,+3,72,44,62%,116,2023/04/03
99,1359,,Dullahan,+2,66,37,64%,103,2023/04/17
100,1359,,miragefla,+3,17,7,71%,24,2023/04/15
101,1357,,DD響,+4,13,3,81%,16,2023/04/13
102,1357,,Emperion,+3,27,10,73%,37,2023/04/17
103,1356,,BananaInPajamas,+4,36,15,71%,51,2023/04/16
104,1356,,Niklas,-1,12,2,86%,14,2023/04/09
105,1355,,Twitch Yunicone≠≠Pony,+15,40,20,67%,60,2023/04/08
106,1355,,Vasto,+4,77,43,64%,120,2023/04/18
107,1346,,bigfriendlybert,+1,12,2,86%,14,2023/03/22
108,1345,,sprout new,-1,47,31,60%,78,2023/04/11
109,1343,,CheeseTonkatsu,+3,19,9,68%,28,2023/03/30
110,1341,,.:PSG:. RedxWings,+3,10,1,91%,11,2023/04/15
111,1341,,AGameAnx,+3,33,11,75%,44,2023/04/17
112,1340,,Sunny,+8,10,1,91%,11,2023/04/11
113,1339,,Hybris,-2,31,13,70%,44,2023/04/07
114,1338,,Arricio,+1,72,49,60%,121,2023/04/17
115,1336,,Sovereign,+1,18,5,78%,23,2023/03/31
116,1336,,herby7,+2,255,199,56%,454,2023/04/17
117,1335,,JZuna,+3,32,14,70%,46,2023/03/29
118,1334,,suomenpaskin,-1,53,27,66%,80,2023/04/04
119,1334,,CeerEd,+5,93,73,56%,166,2023/03/31
120,1331,,-Rλ҉inyCloudCore,+8,9,1,90%,10,2023/04/08
121,1329,,BlueSkidrow,-1,15,7,68%,22,2023/04/07
122,1326,,Hodolf,+1,87,48,64%,135,2023/04/17
123,1325,,快去西天请！如来佛祖,+4,113,90,56%,203,2023/04/10
124,1325,,hireling,+3,67,48,58%,115,2023/04/16
125,1324,,Viklas,+6,14,3,82%,17,2023/04/17
126,1324,,Snoopa,+2,83,54,61%,137,2023/04/14
127,1324,,Dunkerque,+8,20,7,74%,27,2023/04/15
128,1323,,-NSO- Hon3ynuts,+4,32,16,67%,48,2023/03/31
129,1323,,RTX4090,+5,17,5,77%,22,2023/03/26
130,1323,,Dezman,-1,40,22,65%,62,2023/04/13
131,1321,,BiliBilI_24073386_狐狸,+1,9,2,82%,11,2023/04/17
132,1320,,cat tank,+2,45,26,63%,71,2023/03/30
133,1318,,m0ek,+8,24,13,65%,37,2023/03/21
134,1318,,Sweet Pea,+2,149,126,54%,275,2023/04/14
135,1317,,Dr. Jekyll,-1,17,7,71%,24,2023/04/14
136,1316,,1337 HAXX0R,+6,36,18,67%,54,2023/04/04
137,1316,,阴险恶毒熊主任,+2,12,3,80%,15,2023/04/07
138,1316,,CoH2 sucks,+1,59,42,58%,101,2023/04/13
139,1316,,Virgile[FR],-3,50,29,63%,79,2023/04/15
140,1315,,Herr Blautier,+3,56,40,58%,96,2023/03/31
141,1314,,IntegralSweeD,-3,28,15,65%,43,2023/03/31
142,1314,,Sh@dow,+2,25,14,64%,39,2023/04/16
143,1314,,OMGPOP!,+3,16,6,73%,22,2023/04/02
144,1312,,CptLink( jimmy),+2,48,31,61%,79,2023/04/08
145,1312,,Jade Buddha,-1,26,14,65%,40,2023/04/16
146,1312,,Lt Beren,+3,67,49,58%,116,2023/04/12
147,1312,,asd 546,-1,14,4,78%,18,2023/04/11
148,1312,,VulcanHDGaming No.1 Fan,+2,87,51,63%,138,2023/04/06
149,1311,,Stryker,-1,33,19,63%,52,2023/04/16
150,1310,,Hallelujah,-2,31,12,72%,43,2023/04/08
151,1310,,msw.*****,+1,48,38,56%,86,2023/04/17
152,1310,,BlueComp[A]ny,-1,16,6,73%,22,2023/04/15
153,1308,,Panzergrenadierangreifer,+10,10,1,91%,11,2023/04/16
154,1307,,安藤正术,-1,278,250,53%,528,2023/04/17
155,1305,,『BlackBear』,+1,37,19,66%,56,2023/04/11
156,1303,,Enterprise Ω,+2,21,8,72%,29,2023/04/16
157,1303,,MyDiamonD,-1,33,17,66%,50,2023/03/29
158,1302,,FlyingDutchman,+3,26,12,68%,38,2023/04/14
159,1299,,Nation,+1,29,17,63%,46,2023/04/17
160,1299,,FuzZiioN,+2,21,6,78%,27,2023/04/02
161,1299,,UncleClappy,-1,18,9,67%,27,2023/04/17
162,1297,,tightrope,-1,22,12,65%,34,2023/04/17
163,1297,,ssume,+1,123,84,59%,207,2023/04/17
164,1297,,今夜薄雾,+1,15,6,71%,21,2023/04/17
165,1296,,AfroNinja,+7,12,3,80%,15,2023/03/27
166,1296,,Ra11,+1,12,2,86%,14,2023/04/05
167,1296,,Bundy ♥,+3,48,35,58%,83,2023/04/10
168,1295,,Fortune,+3,24,10,71%,34,2023/04/16
169,1294,,[THT] Thusanai,+1,26,16,62%,42,2023/04/03
170,1294,,Van Darkholme,+8,9,1,90%,10,2023/04/02
171,1293,,Tequila Sunset,+1,94,77,55%,171,2023/04/02
172,1293,,Dilophosaur,+1,12,6,67%,18,2023/04/09
173,1292,,Vector,-2,30,13,70%,43,2023/04/16
174,1291,,Loyal,-1,39,31,56%,70,2023/03/25
175,1290,,MP_HappyPanther,+1,11,5,69%,16,2023/04/12
176,1289,,Noah,+9,18,8,69%,26,2023/04/03
177,1289,,Ok.okokok,+4,14,4,78%,18,2023/04/14
178,1287,,Tassos117,+1,28,19,60%,47,2023/04/09
179,1287,,LaDin2,-2,42,31,58%,73,2023/04/14
180,1286,,akutoku,-2,37,24,61%,61,2023/04/15
181,1286,,PaperPadding,+1,20,10,67%,30,2023/04/17
182,1284,,Harold H,+1,38,22,63%,60,2023/04/15
183,1284,,VonAsten,+2,8,2,80%,10,2023/04/14
184,1284,,Authoritarrr,+3,38,26,59%,64,2023/04/13
185,1284,,J_Shizlet,+1,11,2,85%,13,2023/04/16
186,1283,,SkYisTheLimiT,-3,21,11,66%,32,2023/03/31
187,1283,,Khan,+6,40,29,58%,69,2023/04/17
188,1282,,aSIISymbiosis,-1,13,5,72%,18,2023/04/17
189,1282,,Penetron2000,+4,50,43,54%,93,2023/04/17
190,1282,,Tittendachs,-1,9,2,82%,11,2023/04/16
191,1281,,Deru,+7,10,2,83%,12,2023/04/07
192,1281,,Nobiscum Deus,+3,66,46,59%,112,2023/04/05
193,1281,,Vector,-2,19,8,70%,27,2023/04/11
194,1281,,[BPX] Cactlosio,+3,13,4,76%,17,2023/04/14
195,1280,,Rutherford B. Hayes,+1,28,19,60%,47,2023/04/06
196,1279,,ohmygod321,-1,17,10,63%,27,2023/04/06
197,1279,,我不會說中文,+10,10,0,100%,10,2023/03/29
198,1279,,nonononononononono,-1,27,13,68%,40,2023/04/15
199,1278,,Hagen67483,+1,24,14,63%,38,2023/04/09
200,1278,,Peacemaker,+8,32,16,67%,48,2023/04/17
201,1278,,Ghaell,+2,50,37,57%,87,2023/04/16
202,1277,,水银灯,+6,67,55,55%,122,2023/04/12
203,1276,,Exerate,+3,54,38,59%,92,2023/03/29
204,1276,,OHxYEAHxJNP,+3,24,15,62%,39,2023/04/16
205,1275,,Butcher,+1,10,3,77%,13,2023/04/09
206,1275,,McBain,+1,21,9,70%,30,2023/04/14
207,1275,,Boomgoesthedynamite,+2,63,44,59%,107,2023/04/18
208,1272,,Fuzzy Panda,-1,12,5,71%,17,2023/04/17
209,1271,,Pickelhaube Enthusiast,+1,54,42,56%,96,2023/04/14
210,1269,,HighFive,+1,13,4,76%,17,2023/04/10
211,1268,,KlausurenSohn,+1,33,28,54%,61,2023/03/27
212,1268,,Hing-gi,-6,75,49,60%,124,2023/04/14
213,1268,,LemonMint,+2,10,2,83%,12,2023/04/07
214,1266,,himynameisho,+2,15,8,65%,23,2023/04/16
215,1266,,Bufftin,+4,18,10,64%,28,2023/03/26
216,1266,,SexPistole,+3,15,6,71%,21,2023/04/17
217,1266,,citizen.byzantine,+1,13,5,72%,18,2023/03/28
218,1266,,Jimbob2121,+2,69,52,57%,121,2023/04/16
219,1265,,Xyr0N,-1,36,24,60%,60,2023/03/31
220,1265,,Lelano,+4,27,14,66%,41,2023/03/27
221,1265,,GluteusMaximus,+3,12,6,67%,18,2023/04/10
222,1265,,Fabian,-1,11,5,69%,16,2023/04/15
223,1265,,Vosi-K,+1,13,4,76%,17,2023/04/18
224,1263,,How To Win On Lorraine,+2,19,12,61%,31,2023/03/27
225,1262,,rex,+1,8,2,80%,10,2023/03/21
226,1261,,Tré,+1,40,24,63%,64,2023/04/07
227,1261,,SEEETH777,+1,13,7,65%,20,2023/04/17
228,1261,,Unrolled,-2,111,95,54%,206,2023/04/17
229,1261,,Empa,+3,27,16,63%,43,2023/04/16
230,1260,,Snitch,-1,9,3,75%,12,2023/03/31
231,1260,,TOS-1 IMBA,-3,9,3,75%,12,2023/04/16
232,1259,,Dugo,+2,15,7,68%,22,2023/04/17
233,1259,,Fuzer,-4,56,39,59%,95,2023/03/29
234,1259,,JoseyWales_,-1,102,75,58%,177,2023/04/02
235,1259,,Quiritz,+2,12,6,67%,18,2023/04/14
236,1259,,Walther,+1,8,3,73%,11,2023/04/14
237,1257,,qqwqqp,-1,29,20,59%,49,2023/04/10
238,1256,,Lingu,-1,66,52,56%,118,2023/04/17
239,1256,,SuperKeitel,+2,67,50,57%,117,2023/04/17
240,1255,,Souless and Heartless Monkey Man,+2,20,11,65%,31,2023/04/11
241,1254,,Malevolent Pink Cat,+12,25,12,68%,37,2023/04/10
242,1254,,Pony by Nature,+1,19,11,63%,30,2023/04/15
243,1253,,Nostalgia93',+5,35,22,61%,57,2023/04/17
244,1252,,AbangFadil,+7,40,33,55%,73,2023/03/29
245,1251,,西街茶铺三号桌,+1,14,8,64%,22,2023/04/08
246,1251,,Okeyeg,+1,25,17,60%,42,2023/04/12
247,1251,,Cheroid,+3,11,5,69%,16,2023/04/16
248,1251,,KyrreLubiWodę,+1,16,8,67%,24,2023/04/05
249,1251,,SturmTigerGiap,-1,56,47,54%,103,2023/04/15
250,1249,,Scio,-1,9,3,75%,12,2023/03/23
251,1249,,StephennJF,-1,55,39,59%,94,2023/04/17
252,1248,,Nantrix,+4,13,5,72%,18,2023/03/29
253,1248,,xRamee,+1,23,16,59%,39,2023/04/09
254,1248,,Ondross,+2,12,6,67%,18,2023/03/31
255,1247,,InsaneSebbl,+1,10,4,71%,14,2023/04/06
256,1246,,Royally EbRoY,-1,9,4,69%,13,2023/03/30
257,1246,,|DCC|Freestyler,+2,24,15,62%,39,2023/04/04
258,1246,,Baron_Kaban,+1,11,5,69%,16,2023/03/26
259,1245,,Shibal,+4,11,4,73%,15,2023/04/07
260,1245,,Firewasp,-1,20,11,65%,31,2023/03/24
261,1245,,Quadro,+1,16,9,64%,25,2023/04/15
262,1245,,Corpse,+7,9,1,90%,10,2023/04/10
263,1244,,Dromaeda,-1,20,10,67%,30,2023/04/11
264,1244,,dororin3,+4,9,2,82%,11,2023/03/26
265,1243,,Cheezus,+3,81,61,57%,142,2023/04/14
266,1243,,F1NGGY,+2,38,23,62%,61,2023/04/14
267,1243,,#Dariusluck,-1,58,51,53%,109,2023/04/15
268,1243,,耀眼,+1,11,5,69%,16,2023/04/04
269,1240,,T.R. 3nder,+2,15,8,65%,23,2023/03/25
270,1240,,normad,+2,24,16,60%,40,2023/04/13
271,1240,,Stempolbyku,+5,10,3,77%,13,2023/04/05
272,1239,,WebsterBolek,-1,13,6,68%,19,2023/04/11
273,1238,,Dansara,+2,10,3,77%,13,2023/03/30
274,1238,,Italian Space Mafia,+1,62,51,55%,113,2023/04/15
275,1238,,Good Ol' Czepis,-3,9,5,64%,14,2023/04/16
276,1238,,Jeiseun,+1,60,47,56%,107,2023/04/03
277,1238,,GentleFox,+2,25,15,63%,40,2023/04/17
278,1238,,Lazy Ren,+1,11,4,73%,15,2023/04/11
279,1237,,Skadi,+1,10,6,63%,16,2023/04/17
280,1237,,Assyrian♱,-1,33,21,61%,54,2023/04/10
281,1237,,Panzy Spliter,+2,49,39,56%,88,2023/04/17
282,1237,,Mandu,+1,13,9,59%,22,2023/03/30
283,1236,,Raptorjesus,-1,10,3,77%,13,2023/04/06
284,1236,,NANAMI,+3,12,6,67%,18,2023/03/23
285,1235,,AceHiro,-4,25,17,60%,42,2023/04/03
286,1235,,Del,-1,55,41,57%,96,2023/04/17
287,1235,,Sosorryman,+5,9,2,82%,11,2023/03/25
288,1234,,KINDERPARTY,+1,56,38,60%,94,2023/04/17
289,1233,,Mr. Fahrenheit,+1,53,37,59%,90,2023/04/17
290,1233,,5a6a7a,+4,150,133,53%,283,2023/04/17
291,1233,,Bad Ash,+3,22,13,63%,35,2023/04/16
292,1233,,Marcello,+1,26,17,60%,43,2023/04/16
293,1232,,I hope this game dies.,+16,57,43,57%,100,2023/04/17
294,1232,,VindicareX,-2,16,11,59%,27,2023/04/13
295,1232,,ChuaMC,-1,29,20,59%,49,2023/04/17
296,1231,,Koenig,+1,61,48,56%,109,2023/03/31
297,1230,,TankinatorXD,-1,8,3,73%,11,2023/04/16
298,1230,,CPU-Easy,+1,35,26,57%,61,2023/03/25
299,1229,,GOTE,+2,10,3,77%,13,2023/04/06
300,1228,,ChocolateStarfish,+1,20,10,67%,30,2023/04/08
301,1228,,grun59,-1,27,21,56%,48,2023/03/31
302,1228,,Lady Rytsu,+5,16,6,73%,22,2023/03/29
303,1228,,Elisabeth Eugenie,+2,18,9,67%,27,2023/04/07
304,1227,,darkerdayzud,+4,75,62,55%,137,2023/04/17
305,1227,,给我一颗星,-1,23,12,66%,35,2023/04/17
306,1226,,matwyr,-1,21,17,55%,38,2023/04/15
307,1226,,Madscientist,+1,12,7,63%,19,2023/03/30
308,1225,,Quack,+1,32,19,63%,51,2023/04/16
309,1225,,Philbit,+1,37,31,54%,68,2023/04/17
310,1225,,BusinessBryce,+2,70,54,56%,124,2023/04/13
311,1224,,LostsKy_Deity,+6,82,59,58%,141,2023/04/16
312,1224,,Elaina,-2,8,2,80%,10,2023/04/10
313,1224,,NeuralBooch,+1,60,44,58%,104,2023/04/17
314,1224,,JackTW The VTUBER,+1,16,7,70%,23,2023/04/08
315,1223,,Mathew Leeman,+2,91,84,52%,175,2023/04/17
316,1222,,StoBez,+2,13,7,65%,20,2023/03/27
317,1222,,Esxile,+1,11,6,65%,17,2023/04/16
318,1222,,SWATTom,+4,65,57,53%,122,2023/04/14
319,1222,,cћk247,+1,36,24,60%,60,2023/04/07
320,1221,,Kaduin,+1,40,31,56%,71,2023/04/16
321,1221,,gilashley,+3,14,8,64%,22,2023/04/04
322,1220,,Alex.,+4,20,11,65%,31,2023/03/31
323,1219,,Broly,+7,26,14,65%,40,2023/04/07
324,1219,,juan.aldava,+2,18,11,62%,29,2023/04/09
325,1219,,Anilasabyss,-3,11,8,58%,19,2023/04/09
326,1218,,GenObi,+4,27,16,63%,43,2023/04/10
327,1218,,Obi Wan Tap Kenobi,+1,11,5,69%,16,2023/04/12
328,1217,,Makros,-1,15,8,65%,23,2023/03/28
329,1217,,smallNhii,+1,7,3,70%,10,2023/04/13
330,1217,,Lifer,+2,21,13,62%,34,2023/04/14
331,1216,,ZRL454,+1,16,10,62%,26,2023/04/16
332,1216,,"Zoey, Cyberpunk Communist",+2,10,4,71%,14,2023/03/22
333,1215,,Major Storm,+6,19,10,66%,29,2023/04/11
334,1215,,Sticket,+3,18,12,60%,30,2023/03/31
335,1215,,Cular13,+2,30,20,60%,50,2023/04/13
336,1215,,Mando,+2,23,14,62%,37,2023/03/29
337,1215,,Jae,+2,26,12,68%,38,2023/04/14
338,1214,,zhuk0v,-3,20,14,59%,34,2023/04/16
339,1214,,Rasler63,+1,23,13,64%,36,2023/04/13
340,1214,,P-Money,+1,11,4,73%,15,2023/04/13
341,1214,,ralneck52,+1,59,50,54%,109,2023/04/16
342,1213,,fsoutomendes,+2,169,149,53%,318,2023/04/17
343,1213,,piper dawn,-2,9,5,64%,14,2023/03/30
344,1213,,longyouaak,-4,59,39,60%,98,2023/04/12
345,1213,,StatusQuoMSK,+2,10,5,67%,15,2023/03/23
346,1213,,Redhorrn,-2,17,11,61%,28,2023/03/22
347,1212,,Tung,-3,126,112,53%,238,2023/04/16
348,1211,,[EL] Senpai Ares,-1,30,21,59%,51,2023/04/16
349,1211,,Nesli,-1,11,4,73%,15,2023/04/17
350,1210,,Aerohank,+2,8,3,73%,11,2023/04/07
351,1210,,DiddlyHole,+6,19,8,70%,27,2023/04/15
352,1209,,Reakly,-1,26,13,67%,39,2023/04/15
353,1209,,VulcanHDGaming,-1,13,7,65%,20,2023/04/15
354,1209,,UAV ONLiNE,+1,11,9,55%,20,2023/04/12
355,1209,,The Whistler,+3,16,9,64%,25,2023/03/29
356,1209,,Slyzor,-1,32,28,53%,60,2023/04/03
357,1209,,Irrelephant,-6,30,24,56%,54,2023/04/03
358,1208,,101st.Airbone,-2,9,4,69%,13,2023/04/16
359,1208,,Minka1u1,+1,7,4,64%,11,2023/03/23
360,1208,,Kayaking Koala,-2,28,21,57%,49,2023/04/09
361,1207,,Trivolka,+3,32,25,56%,57,2023/04/17
362,1207,,loovus,-1,45,34,57%,79,2023/04/09
363,1207,,alienman,+1,13,7,65%,20,2023/04/17
364,1205,,Dyldog,+1,8,3,73%,11,2023/04/06
365,1205,,^1Soldat^0James,+2,20,13,61%,33,2023/04/09
366,1205,,Destroyer,+1,20,12,63%,32,2023/04/17
367,1204,,Simplify,-1,16,11,59%,27,2023/04/03
368,1204,,Spitfire,-1,20,13,61%,33,2023/03/28
369,1204,,whynot,-1,11,5,69%,16,2023/04/01
370,1203,,总维新,-2,19,12,61%,31,2023/04/05
371,1203,,Pinky```,-1,64,57,53%,121,2023/04/17
372,1203,,Luk,+3,14,10,58%,24,2023/04/01
373,1200,,BurdenedWarrior,+6,10,3,77%,13,2023/03/31
374,1200,,ReadyForDisappointment,+8,32,19,63%,51,2023/04/16
375,1200,,Lvce_Del_Dvce,+2,11,5,69%,16,2023/04/15
376,1199,,colinmeier50,+3,22,14,61%,36,2023/03/27
377,1199,,Gn_Patton,-2,67,53,56%,120,2023/04/08
378,1199,,swdertfht,+1,14,7,67%,21,2023/04/16
379,1199,,IIIIIIIIIII7,+1,7,3,70%,10,2023/03/28
380,1198,,鸡饲料锐评农场主,-1,29,25,54%,54,2023/04/16
381,1198,,Zyswen,+1,23,18,56%,41,2023/04/15
382,1198,,Amouranth,+2,7,3,70%,10,2023/04/15
383,1198,,JShreddy,+4,25,16,61%,41,2023/04/13
384,1198,,DIRTY_FISHERMAN,-2,18,12,60%,30,2023/03/30
385,1198,,Panzerfaust,+1,39,29,57%,68,2023/04/15
386,1197,,FlAyPiGg,+3,25,18,58%,43,2023/03/29
387,1197,,Mercenary90,+3,22,13,63%,35,2023/04/16
388,1197,,瓦豆魯迪開扁,-2,8,4,67%,12,2023/04/05
389,1196,,aBurningDog,+1,22,15,59%,37,2023/03/24
390,1196,,我剑也未尝不利,-1,78,66,54%,144,2023/04/12
391,1195,,......,-2,67,55,55%,122,2023/04/14
392,1195,,Wywtigerking,+1,71,57,55%,128,2023/04/16
393,1195,,-Cr4nk-,+1,16,9,64%,25,2023/04/16
394,1195,,Lick3tySplit,+3,10,5,67%,15,2023/04/09
395,1194,,Kirov,+4,40,30,57%,70,2023/03/22
396,1194,,Salt Monkey,-1,62,48,56%,110,2023/04/17
397,1193,,Gunnerside,+2,89,82,52%,171,2023/04/14
398,1193,,TomatoSoup,+3,12,6,67%,18,2023/03/24
399,1193,,Firestorm,+1,8,3,73%,11,2023/04/09
400,1191,,Vince,+3,47,38,55%,85,2023/04/09
401,1191,,Desertfox,+5,10,5,67%,15,2023/04/01
402,1191,,Wreath Noël,-1,23,18,56%,41,2023/04/08
403,1191,,76561198046408390,-2,55,43,56%,98,2023/03/25
404,1191,,Filly,-1,9,5,64%,14,2023/03/25
405,1191,,ACE_HESS,+3,251,221,53%,472,2023/04/18
406,1191,,TimFranks,+1,14,9,61%,23,2023/03/30
407,1190,,Nachosguy,+2,20,11,65%,31,2023/04/17
408,1190,,Kraut,+1,15,9,63%,24,2023/04/06
409,1190,,FocXD_YT,-1,19,14,58%,33,2023/03/23
410,1190,,iaguz,-1,9,4,69%,13,2023/03/24
411,1189,,~SB 真多~,-3,52,47,53%,99,2023/04/14
412,1189,,Hachald,+6,23,16,59%,39,2023/04/16
413,1188,,Crovax,-1,26,17,60%,43,2023/04/10
414,1188,,Trigun,-4,34,26,57%,60,2023/04/09
415,1187,,wardog,+2,10,4,71%,14,2023/04/09
416,1187,,Mintjack,-1,16,9,64%,25,2023/04/17
417,1186,,Begbie,+1,24,22,52%,46,2023/03/25
418,1186,,offmask,+8,18,10,64%,28,2023/04/10
419,1186,,Dolan,+1,9,4,69%,13,2023/04/14
420,1186,,turkey cat,+1,19,13,59%,32,2023/04/17
421,1184,,Royal Annihilator,-2,52,44,54%,96,2023/04/10
422,1184,,Iron_Sarge69,+4,46,38,55%,84,2023/04/12
423,1184,,Synthesis,+2,9,3,75%,12,2023/04/02
424,1183,,aemonespinel,-3,60,48,56%,108,2023/04/16
425,1183,,Herald of Tzeench,-1,8,4,67%,12,2023/04/07
426,1183,,Fat Nanny,+4,15,9,63%,24,2023/04/15
427,1183,,Commander_Utus,+1,7,3,70%,10,2023/04/03
428,1183,,John Paul II,-1,11,7,61%,18,2023/04/14
429,1182,,Kylen,+2,17,12,59%,29,2023/04/14
430,1182,,Pandemic,-4,17,13,57%,30,2023/04/16
431,1181,,≡[EZGK]≡ T3dgO13,+1,45,39,54%,84,2023/04/10
432,1181,,Dark Space,+1,10,5,67%,15,2023/04/05
433,1181,,MonkeyWang,+1,7,3,70%,10,2023/04/02
434,1181,,Etiyen,+1,56,52,52%,108,2023/04/16
435,1180,,BrainSplat | SoĿΛΠ,-1,30,24,56%,54,2023/03/30
436,1179,,Jünker,-1,32,30,52%,62,2023/04/17
437,1179,,Dinkey King,-1,8,2,80%,10,2023/03/23
438,1179,,el deglingoo,+1,15,9,63%,24,2023/03/31
439,1179,,Free Stasiu,+4,17,10,63%,27,2023/04/16
440,1178,,Arhok,+3,23,13,64%,36,2023/04/16
441,1178,,niksa,+4,7,3,70%,10,2023/03/21
442,1178,,Kamfrenchie,+1,11,7,61%,18,2023/03/25
443,1178,,All Day,+6,12,5,71%,17,2023/04/16
444,1177,,xxxDerOzelotxxx,+1,7,3,70%,10,2023/04/07
445,1177,,Izolacja,+5,27,16,63%,43,2023/03/28
446,1177,,cheems澤東,+1,23,16,59%,39,2023/04/15
447,1176,,dbsights,+1,30,21,59%,51,2023/03/31
448,1176,,KC,+3,38,26,59%,64,2023/03/27
449,1176,,DALT11,+2,30,21,59%,51,2023/04/14
450,1176,,Leorique,-2,13,7,65%,20,2023/03/24
451,1176,,C.G. Jung,-2,31,28,53%,59,2023/04/17
452,1176,,Lanfeust,+2,29,26,53%,55,2023/04/17
453,1175,,TowerNumberNine,+1,55,42,57%,97,2023/04/14
454,1175,,Grunk,+3,8,3,73%,11,2023/04/02
455,1175,,Gooby,-1,36,31,54%,67,2023/04/03
456,1175,,Watchmedothis,+7,11,6,65%,17,2023/04/16
457,1174,,Papra,+1,43,35,55%,78,2023/04/13
458,1174,,CrazyEight1994,+1,17,14,55%,31,2023/04/16
459,1174,,Adadis,+2,26,17,60%,43,2023/04/17
460,1174,,FullMeanMachine,-2,8,4,67%,12,2023/04/17
461,1173,,5a5e,-1,46,38,55%,84,2023/03/23
462,1173,,LB,-2,11,8,58%,19,2023/04/10
463,1173,,Lippo,+5,46,32,59%,78,2023/04/15
464,1173,,RNGesus,+3,14,8,64%,22,2023/04/17
465,1173,,BigLang,+1,50,47,52%,97,2023/04/17
466,1173,,Gravemouth,+3,46,39,54%,85,2023/04/09
467,1173,,Ruhrfale,+3,14,8,64%,22,2023/04/06
468,1173,,CocusMagnus,-4,22,15,59%,37,2023/04/03
469,1172,,Sarg gX,+1,14,9,61%,23,2023/04/01
470,1172,,gl hf gg wp,+1,9,7,56%,16,2023/04/01
471,1171,,JustLemon,+4,13,8,62%,21,2023/04/14
472,1171,,Obscura,-1,8,5,62%,13,2023/04/11
473,1171,,Swol Team 6,+1,10,5,67%,15,2023/03/24
474,1171,,Gvalch'ca,-2,53,45,54%,98,2023/04/02
475,1171,,Naat,+2,9,6,60%,15,2023/04/02
476,1170,,CrazyMazzei217,-2,9,6,60%,15,2023/03/23
477,1170,,TheVVitcher,+1,6,4,60%,10,2023/03/27
478,1170,,ChaBoi,+1,18,12,60%,30,2023/04/10
479,1170,,Azakura,-5,50,40,56%,90,2023/04/15
480,1170,,mor117,+2,7,3,70%,10,2023/04/17
481,1170,,Shockz,+2,25,16,61%,41,2023/04/15
482,1169,,A-淌者如溪,+10,14,6,70%,20,2023/03/24
483,1169,,Ryan,+4,9,4,69%,13,2023/03/24
484,1169,,Noob Nath,-2,48,41,54%,89,2023/04/16
485,1169,,denny870522,+2,15,11,58%,26,2023/04/16
486,1169,,DarkAlric,-1,75,65,54%,140,2023/04/16
487,1169,,[DeanOfBao]hokkskyc,+1,8,6,57%,14,2023/03/23
488,1169,,Lord Blackwood,-4,14,10,58%,24,2023/04/01
489,1168,,Brokenstaples,-2,19,12,61%,31,2023/03/26
490,1168,,BiliBilI_23984226_Luckyman55,+4,16,13,55%,29,2023/04/09
491,1168,,MotoBomb,+3,13,11,54%,24,2023/04/17
492,1168,,Boop,+1,10,6,63%,16,2023/04/14
493,1168,,Psycho,-2,21,16,57%,37,2023/04/05
494,1168,,Faramir,+3,8,5,62%,13,2023/04/04
495,1168,,vCoh,+3,8,3,73%,11,2023/04/17
496,1167,,High Testosterone Player,+3,17,11,61%,28,2023/03/31
497,1167,,Saxonyflori,+3,10,7,59%,17,2023/04/15
498,1166,,AndreiM2006,-3,29,24,55%,53,2023/04/08
499,1166,,[xtc]Luckyday,+1,148,141,51%,289,2023/04/18
500,1166,,Trademark,+10,17,9,65%,26,2023/04/14
501,1166,,Schreihalz Λ,-1,17,10,63%,27,2023/04/15
502,1165,,VndctL,-1,65,56,54%,121,2023/04/18
503,1165,,lolmoe,-1,15,9,63%,24,2023/03/23
504,1165,,lubi,+2,22,15,59%,37,2023/04/17
505,1165,,Gnorri,+4,14,7,67%,21,2023/04/15
506,1165,,契弟走得摩,+3,8,4,67%,12,2023/03/27
507,1165,,Maxi,+3,8,4,67%,12,2023/04/09
508,1165,,Aenaos07,-2,10,6,63%,16,2023/04/13
509,1164,,RDXL,+7,31,24,56%,55,2023/04/16
510,1164,,tubagznyven,+1,22,16,58%,38,2023/04/12
511,1164,,Der_Therapeut,+1,16,13,55%,29,2023/04/08
512,1164,,Mike,+1,36,33,52%,69,2023/04/12
513,1164,,Parasite,+2,16,12,57%,28,2023/04/09
514,1164,,✡ Merchant ✡,-1,22,12,65%,34,2023/04/07
515,1164,,Killervirus,-3,25,19,57%,44,2023/04/06
516,1163,,bLiTz,+1,121,111,52%,232,2023/04/13
517,1163,,Cinek,-1,7,3,70%,10,2023/03/29
518,1163,,apples_n,+3,19,16,54%,35,2023/04/07
519,1163,,Vinby,+1,8,4,67%,12,2023/04/17
520,1163,,Lukyboom,-1,31,21,60%,52,2023/04/16
521,1163,,Mas91_IMB,-2,10,7,59%,17,2023/03/22
522,1163,,sturmbrichtlos,-2,9,6,60%,15,2023/04/13
523,1163,,Strategos,+2,9,4,69%,13,2023/04/16
524,1163,,Nekrophage,+3,8,4,67%,12,2023/03/24
525,1162,,papanash,+1,52,48,52%,100,2023/04/13
526,1162,,_MCA_max1336,-3,10,7,59%,17,2023/04/15
527,1162,,Mr.Cat,+5,33,24,58%,57,2023/04/17
528,1162,,Seshagrantch,-1,47,39,55%,86,2023/03/30
529,1162,,Beregonds,+2,16,8,67%,24,2023/04/05
530,1161,,Tortugen,-2,9,7,56%,16,2023/04/09
531,1161,,Gray,+5,9,4,69%,13,2023/04/17
532,1161,,alu,+1,7,3,70%,10,2023/03/26
533,1161,,Ms. Glasc,-7,11,7,61%,18,2023/04/02
534,1161,,Arres,-1,44,37,54%,81,2023/04/17
535,1161,,pallie yes,-2,12,7,63%,19,2023/03/28
536,1161,,limewizz,-3,7,4,64%,11,2023/03/30
537,1161,,Fernando87ca,-1,35,26,57%,61,2023/04/15
538,1161,,Kaypen97,+1,13,8,62%,21,2023/03/29
539,1160,,J3WN1aL8T0R,-1,19,14,58%,33,2023/04/13
540,1160,,MaYoR,+4,10,5,67%,15,2023/03/25
541,1160,,Jsizzle,-3,21,17,55%,38,2023/03/21
542,1159,,Nenn mich Alex,-1,30,22,58%,52,2023/04/09
543,1159,,TheKingofRome,+3,22,13,63%,35,2023/04/17
544,1159,,PoteRush,+2,23,21,52%,44,2023/04/17
545,1159,,HORUS,-1,82,72,53%,154,2023/04/17
546,1159,,Adlet Mayer,+2,81,70,54%,151,2023/04/13
547,1159,,CHINESE DO NOT SPEAK ENGLISH,+1,29,23,56%,52,2023/04/15
548,1159,,动感超人和他的勒贝尔,+2,37,32,54%,69,2023/04/16
549,1159,,Junkz,+3,13,6,68%,19,2023/04/08
550,1158,,Goodvyn,+4,155,133,54%,288,2023/04/10
551,1158,,SkalliSol,-1,7,4,64%,11,2023/04/08
552,1157,,Colonel0tto,-1,13,9,59%,22,2023/03/24
553,1157,,ⓩᵉʳᵒ,+1,14,9,61%,23,2023/04/02
554,1157,,Vladyslavius,+1,11,7,61%,18,2023/04/17
555,1157,,Soviet Duck,-1,7,3,70%,10,2023/03/25
556,1157,,BALCK_9,+1,26,21,55%,47,2023/04/09
557,1155,,Spades68,+2,12,10,55%,22,2023/04/03
558,1155,,Confl1ct.BR,-2,86,75,53%,161,2023/04/16
559,1154,,loleg,+3,7,4,64%,11,2023/03/31
560,1154,,GeeNo,+1,11,7,61%,18,2023/03/31
561,1154,,hirohirofvvv,+3,10,8,56%,18,2023/04/16
562,1154,,Brother from another mother,+1,39,36,52%,75,2023/04/13
563,1154,,赤色彗星,-1,11,7,61%,18,2023/04/13
564,1154,,Decs,+6,25,15,63%,40,2023/03/21
565,1153,,dire,+2,202,186,52%,388,2023/04/18
566,1153,,phx.Mohikaner,-1,24,18,57%,42,2023/04/13
567,1153,,中國武漢肺炎,+1,16,14,53%,30,2023/04/17
568,1153,,Stupid Sexy Julian,-1,30,23,57%,53,2023/04/16
569,1153,,Maup,+3,8,4,67%,12,2023/04/10
570,1153,,Synthsere,+1,12,8,60%,20,2023/04/14
571,1153,,BeerGrills,+2,7,3,70%,10,2023/04/16
572,1153,,Thomas Gottschalk,+2,7,3,70%,10,2023/04/03
573,1153,,Sadam Hussein but Bóbr,-2,13,9,59%,22,2023/03/24
574,1152,,Trve Kvlt,+1,14,10,58%,24,2023/04/14
575,1151,,[TB] Pvt. Mike,+1,11,8,58%,19,2023/04/03
576,1151,,Rasputin,+1,33,25,57%,58,2023/04/15
577,1151,,一九九四秋,+1,11,4,73%,15,2023/04/01
578,1151,,I Find A Computer Indispensable,+8,19,15,56%,34,2023/04/14
579,1151,,Zansibar,-2,11,7,61%,18,2023/04/09
580,1151,,RunningFatKids,-1,15,12,56%,27,2023/04/17
581,1150,,mocik(PL),+1,7,4,64%,11,2023/04/08
582,1149,,Razer,-3,13,9,59%,22,2023/04/14
583,1149,,Enes,-3,9,6,60%,15,2023/03/28
584,1149,,RoXoR,+1,7,3,70%,10,2023/03/31
585,1149,,Lion king,+2,57,48,54%,105,2023/04/05
586,1149,,fasteddie8,+1,73,61,54%,134,2023/04/17
587,1149,,FANBOY,+2,54,42,56%,96,2023/04/16
588,1149,,codiece,+4,19,13,59%,32,2023/04/17
589,1149,,Seemann,+2,20,13,61%,33,2023/03/29
590,1149,,GrownUp,+1,16,11,59%,27,2023/04/17
591,1149,,Bucho Burns,+2,18,14,56%,32,2023/03/25
592,1148,,Kordi,+1,6,5,55%,11,2023/03/22
593,1148,,Chibitz,+1,25,18,58%,43,2023/03/25
594,1147,,tobles,+3,24,22,52%,46,2023/04/01
595,1147,,Joker239,+3,14,7,67%,21,2023/03/29
596,1147,,WINTER,+2,13,8,62%,21,2023/04/17
597,1146,,Lord Gordon Semen,+3,9,4,69%,13,2023/04/16
598,1145,,<WSP>Point Man,-1,7,3,70%,10,2023/04/02
599,1145,,Fueller_leer,+1,18,12,60%,30,2023/03/30
600,1145,,Bames Nond Having A Stronk,-2,24,22,52%,46,2023/04/17
601,1145,,Esel,+1,17,12,59%,29,2023/04/17
602,1145,,Morsezeichen,-1,125,117,52%,242,2023/04/18
603,1144,,伐伐伐伐伐木工,+1,50,47,52%,97,2023/04/16
604,1144,,Mentat,+2,22,17,56%,39,2023/04/17
605,1144,,Kaellaane,-1,7,3,70%,10,2023/04/06
606,1144,,Chiico,+3,16,13,55%,29,2023/04/17
607,1143,,Cipher,+1,11,8,58%,19,2023/04/07
608,1143,,Florian Geyer von Giebelstadt,+1,31,29,52%,60,2023/04/10
609,1142,,Franz,-3,14,9,61%,23,2023/04/16
610,1142,,bluegreen,+2,12,9,57%,21,2023/04/01
611,1142,,LOPO,+1,28,19,60%,47,2023/04/08
612,1142,,DerKalli,-1,10,7,59%,17,2023/04/05
613,1142,,Moving-Hoon,+1,12,10,55%,22,2023/03/30
614,1142,,Kamikaze Scotsman,-2,23,18,56%,41,2023/04/10
615,1140,,-G.N-Leon·Scott·Kennedy,-2,9,5,64%,14,2023/04/16
616,1140,,ZEB,+2,60,56,52%,116,2023/04/17
617,1140,,TheGoodMoose,+1,20,13,61%,33,2023/04/16
618,1140,,Aleaux,+1,10,5,67%,15,2023/04/12
619,1139,,xXxVV177D3B345TxXx,-3,7,4,64%,11,2023/04/01
620,1139,,WazzaBozza,+3,8,5,62%,13,2023/04/08
621,1139,,Templariusz,-2,18,11,62%,29,2023/04/16
622,1139,,EtherealDragon,+5,24,19,56%,43,2023/04/10
623,1139,,Malenkiy_Apelsin,-1,13,12,52%,25,2023/03/30
624,1138,,Tw!sT,+1,12,9,57%,21,2023/04/11
625,1138,,MacP,+3,21,13,62%,34,2023/04/07
626,1137,,ciamgyic,+5,24,28,46%,52,2023/03/21
627,1137,,DarkPact,+7,23,19,55%,42,2023/04/04
628,1137,,Wuppie,-1,9,6,60%,15,2023/04/16
629,1137,,Dave,-4,53,43,55%,96,2023/04/10
630,1136,,Storm,+2,22,17,56%,39,2023/04/16
631,1136,,Stormless,-3,9,7,56%,16,2023/04/17
632,1136,,Erebys,-1,10,7,59%,17,2023/03/25
633,1136,,Cory The Gardener,+1,14,9,61%,23,2023/04/14
634,1135,,moletsplui,-1,73,61,54%,134,2023/04/13
635,1135,,CasuallyLax,-1,34,25,58%,59,2023/04/17
636,1135,,Bambusleitung,-4,9,7,56%,16,2023/04/03
637,1135,,ETZUMD,-3,21,17,55%,38,2023/04/12
638,1135,,Seocheon,+5,16,10,62%,26,2023/03/30
639,1135,,Wolfwood,-2,93,93,50%,186,2023/04/17
640,1135,,MILFHunterTTV,-3,44,42,51%,86,2023/04/14
641,1135,,ScarletShin,-1,9,5,64%,14,2023/04/14
642,1134,,Pwnbot,+2,9,7,56%,16,2023/04/02
643,1134,,Suicise,-3,6,4,60%,10,2023/03/25
644,1134,,NoMatterWha,+5,12,8,60%,20,2023/04/17
645,1134,,Thomas,+5,18,11,62%,29,2023/04/10
646,1134,,白织,+1,46,41,53%,87,2023/04/16
647,1133,,Imaturkeith,+2,16,9,64%,25,2023/04/14
648,1133,,乔龙迪克,-13,203,171,54%,374,2023/04/14
649,1133,,Vitzy J,-1,14,12,54%,26,2023/04/07
650,1133,,Metzel,-1,15,12,56%,27,2023/04/17
651,1133,,Cpt. Unicorn,-3,10,7,59%,17,2023/04/16
652,1132,,SuppEngineer,+4,7,3,70%,10,2023/03/22
653,1132,,LighTLuZ.,-1,6,5,55%,11,2023/03/22
654,1132,,AAA karasino,+2,9,5,64%,14,2023/04/05
655,1132,,shinjp,+7,35,20,64%,55,2023/04/02
656,1131,,HAN-[cw]100980315,+1,9,5,64%,14,2023/04/10
657,1131,,Kim Jong-un,+3,9,5,64%,14,2023/04/07
658,1131,,mrce,-1,8,4,67%,12,2023/04/15
659,1131,,Daniel(TFB),-3,8,5,62%,13,2023/03/30
660,1131,,NBO99,-1,6,4,60%,10,2023/04/04
661,1131,,ᚱ:ᛋ:ᚨ | ᛁᚲᚨᚱᚢᛋ,-2,14,11,56%,25,2023/03/24
662,1130,,1st SubStar,+1,32,23,58%,55,2023/04/10
663,1130,,John 14,+1,16,13,55%,29,2023/04/17
664,1130,,Boskever!?,+2,8,5,62%,13,2023/03/26
665,1130,,Winters,+2,7,3,70%,10,2023/03/25
666,1130,,AE,-2,7,5,58%,12,2023/04/07
667,1130,,ZeroUno,-2,36,31,54%,67,2023/04/16
668,1130,,DanRegi,+4,9,4,69%,13,2023/04/01
669,1130,,A-Hörnchen,-1,26,19,58%,45,2023/03/26
670,1129,,潘策尔,+2,50,44,53%,94,2023/04/10
671,1129,,Kübelwagen!,+1,35,27,56%,62,2023/04/15
672,1129,,Strategom,-1,6,4,60%,10,2023/04/17
673,1128,,DPdangi28,+4,11,7,61%,18,2023/04/10
674,1128,,Phobos,+1,9,5,64%,14,2023/04/17
675,1128,,cease2existt,+1,28,22,56%,50,2023/04/15
676,1128,,Reemster,+1,24,18,57%,42,2023/03/22
677,1128,,LootGoblin,+2,13,12,52%,25,2023/03/27
678,1128,,Le rat Madan,+2,15,14,52%,29,2023/04/12
679,1128,,Bacaphonic,-2,60,59,50%,119,2023/04/03
680,1128,,Makteridon,+2,8,4,67%,12,2023/03/27
681,1127,,Otvor,+1,20,16,56%,36,2023/04/11
682,1127,,69apm,-1,7,3,70%,10,2023/04/13
683,1127,,comrade14andrei,+2,26,20,57%,46,2023/04/04
684,1127,,CrazyTiger,+1,131,106,55%,237,2023/04/17
685,1127,,Nerus,+1,6,4,60%,10,2023/04/08
686,1127,,Waddn,-4,29,23,56%,52,2023/03/30
687,1126,,yapster,+2,16,11,59%,27,2023/04/16
688,1126,,Saturas,-1,30,26,54%,56,2023/04/15
689,1126,,Euan,+1,10,6,63%,16,2023/04/17
690,1126,,rmsi,-2,11,8,58%,19,2023/04/17
691,1126,,Potato Boy,-1,26,25,51%,51,2023/03/25
692,1125,,Sea raider,+2,8,7,53%,15,2023/04/17
693,1125,,Remarc,-1,6,4,60%,10,2023/04/07
694,1125,,judacomrun,+1,49,50,49%,99,2023/04/17
695,1125,,Burnt Toast,-1,20,18,53%,38,2023/04/09
696,1125,,SShaker,-6,40,43,48%,83,2023/04/17
697,1124,,jinkmoon2,+1,43,35,55%,78,2023/04/16
698,1124,,2506Brigade,+3,16,11,59%,27,2023/04/17
699,1124,,luaey14,-2,12,10,55%,22,2023/04/10
700,1124,,Jens,+2,26,15,63%,41,2023/04/09
701,1123,,BoByBestBoB,+1,36,32,53%,68,2023/04/14
702,1123,,TheRedBaron,+1,7,4,64%,11,2023/04/17
703,1123,,OdaKenji,+3,8,7,53%,15,2023/04/12
704,1123,,Montanas,+2,8,5,62%,13,2023/04/08
705,1123,,AresOfThrace,-2,53,47,53%,100,2023/04/12
706,1123,,AltopS,+1,11,9,55%,20,2023/04/17
707,1123,,Chank Bulkhead,-2,108,105,51%,213,2023/04/16
708,1123,,只愛❤毛妹,+1,9,6,60%,15,2023/04/15
709,1122,,Wolfe,+2,9,5,64%,14,2023/04/15
710,1122,,ErRo,+2,42,43,49%,85,2023/04/16
711,1122,,Pano_ramix,-4,13,12,52%,25,2023/04/15
712,1121,,Pally,+1,23,19,55%,42,2023/03/27
713,1121,,Señor de Ryelight,+1,9,6,60%,15,2023/04/10
714,1120,,101st,+4,13,8,62%,21,2023/04/10
715,1120,,麥尬武村,+2,35,33,51%,68,2023/04/08
716,1119,,SemperFi,-1,18,14,56%,32,2023/04/17
717,1119,,Kiju,-3,26,24,52%,50,2023/04/06
718,1119,,Moonmyung,+2,27,21,56%,48,2023/04/17
719,1119,,talktothehand,-1,7,6,54%,13,2023/04/12
720,1119,,Mike,-1,48,46,51%,94,2023/04/03
721,1119,,'Sexx Luthor,+2,21,15,58%,36,2023/04/11
722,1118,,Juggermarc,+8,26,24,52%,50,2023/04/09
723,1118,,andy1124,-1,6,4,60%,10,2023/04/07
724,1118,,Americano,-2,11,10,52%,21,2023/04/15
725,1118,,.Hesko.,-1,12,11,52%,23,2023/04/16
726,1118,,Miss Piggy,+5,7,4,64%,11,2023/04/16
727,1117,,Daemon7,-2,8,5,62%,13,2023/04/03
728,1117,,Ekko Tek,-3,10,7,59%,17,2023/04/07
729,1117,,martin gu,-1,11,8,58%,19,2023/03/29
730,1117,,DarthPotato,-1,33,24,58%,57,2023/04/02
731,1117,,Doc Holliday,+6,16,12,57%,28,2023/04/04
732,1117,,ChiefRedSkins,-1,19,16,54%,35,2023/04/17
733,1116,,SolidRaziel,+1,142,151,48%,293,2023/04/17
734,1116,,Joebill,+2,7,5,58%,12,2023/04/07
735,1116,,Durkslag,+2,11,6,65%,17,2023/04/01
736,1116,,Wolfsindis,+3,9,5,64%,14,2023/04/14
737,1115,,Mackermicker,+2,10,6,63%,16,2023/03/31
738,1115,,Oskorei,+2,12,9,57%,21,2023/04/03
739,1115,,Nylon,-1,24,23,51%,47,2023/04/17
740,1115,,HOI,+1,28,25,53%,53,2023/04/17
741,1114,,dolph,+2,28,20,58%,48,2023/04/17
742,1114,,Barman,-1,8,6,57%,14,2023/04/13
743,1114,,SHVAKS,-1,22,19,54%,41,2023/04/03
744,1113,,八坂真崎,-1,13,11,54%,24,2023/03/26
745,1113,,DirtMcGirt,+4,16,12,57%,28,2023/04/17
746,1113,,ASWZ ScrotalLord,+3,27,22,55%,49,2023/04/10
747,1113,,karl,+1,19,12,61%,31,2023/04/05
748,1113,,Sergeant,+1,35,27,56%,62,2023/04/14
749,1112,,James Brown,+2,93,84,53%,177,2023/04/17
750,1112,,Aerozeppelin,-2,40,34,54%,74,2023/04/17
751,1112,,Kruton,+3,15,9,63%,24,2023/03/31
752,1112,,C.R.E.A.M,+2,9,6,60%,15,2023/04/10
753,1112,,BigGameHUnter,+5,18,14,56%,32,2023/04/16
754,1112,,HongWen,-1,14,9,61%,23,2023/03/30
755,1112,,Bears Beets,+1,55,44,56%,99,2023/04/17
756,1112,,Los ewok,+2,7,4,64%,11,2023/04/12
757,1111,,theDctore_,-1,7,4,64%,11,2023/04/03
758,1111,,WouldULike2BeAPepper2?,-2,10,7,59%,17,2023/04/14
759,1111,,终不似 少年游,+1,18,14,56%,32,2023/04/12
760,1111,,Crossbone,-1,8,5,62%,13,2023/04/02
761,1111,,Aliebuda,+2,19,12,61%,31,2023/04/17
762,1110,,Xyr1n,+1,17,18,49%,35,2023/04/17
763,1110,,Lethal,+1,28,21,57%,49,2023/04/15
764,1110,,Invokerka,-1,41,40,51%,81,2023/04/17
765,1110,,TerpeneProfile,+5,7,3,70%,10,2023/04/11
766,1110,,奶奶的厄斐琉斯,+3,8,4,67%,12,2023/04/13
767,1109,,Ol'Smokey,-2,109,99,52%,208,2023/04/09
768,1109,,Vettlen,+1,7,4,64%,11,2023/04/07
769,1109,,OnkelDoktor,+1,13,8,62%,21,2023/04/01
770,1109,,恩恩,-3,49,40,55%,89,2023/04/16
771,1109,,soyboy harryson,+7,35,28,56%,63,2023/04/17
772,1109,,joe,-1,17,12,59%,29,2023/04/11
773,1109,,Empire,+5,17,15,53%,32,2023/03/29
774,1108,,xd,+1,8,4,67%,12,2023/04/12
775,1108,,Thanis,+1,11,7,61%,18,2023/04/16
776,1108,,Uncle Soekarno,+2,42,35,55%,77,2023/04/10
777,1108,,快乐树骑士团,-2,32,26,55%,58,2023/03/30
778,1108,,Paranoia,+1,37,35,51%,72,2023/04/16
779,1108,,乌拉,+3,9,5,64%,14,2023/04/12
780,1107,,AngelSSword,+1,31,23,57%,54,2023/04/14
781,1107,,Su7.Y,-3,16,11,59%,27,2023/03/30
782,1107,,Joshua,+2,52,52,50%,104,2023/04/16
783,1107,,Jdal,-1,8,7,53%,15,2023/03/30
784,1107,,cakesucker,+2,45,40,53%,85,2023/03/25
785,1107,,Jopjahh,+1,6,5,55%,11,2023/04/06
786,1106,,ßoo,+1,15,10,60%,25,2023/04/11
787,1106,,yoonjh591,-3,6,4,60%,10,2023/03/24
788,1105,,bisivan1,+1,22,20,52%,42,2023/04/17
789,1105,,JJuKKuRi,+1,13,10,57%,23,2023/04/13
790,1105,,kluwejo,-3,19,22,46%,41,2023/04/17
791,1104,,Macke,+1,11,7,61%,18,2023/04/16
792,1104,,Lysol,-6,13,14,48%,27,2023/04/04
793,1103,,Window Shopping,-4,40,36,53%,76,2023/04/17
794,1103,,AHL,+4,14,13,52%,27,2023/04/04
795,1103,,BaconXL,+1,24,18,57%,42,2023/04/17
796,1103,,MJRniko,-2,8,7,53%,15,2023/04/13
797,1103,,[TUBA] Sirbiggles70,-1,5,5,50%,10,2023/03/27
798,1103,,Kusty,-1,31,21,60%,52,2023/04/02
799,1103,,Chu,+2,17,12,59%,29,2023/04/15
800,1102,,Studano,+1,9,5,64%,14,2023/04/17
801,1102,,MrKaos,-1,24,20,55%,44,2023/04/17
802,1101,,XBound,-1,8,6,57%,14,2023/04/08
803,1101,,Roy,+1,17,13,57%,30,2023/03/29
804,1101,,HasBeenDropped,-1,8,7,53%,15,2023/04/15
805,1101,,403671774,-5,43,41,51%,84,2023/04/12
806,1101,,Lieut✪LunchBox,-4,22,21,51%,43,2023/04/15
807,1101,,Hefe,+1,13,11,54%,24,2023/04/18
808,1101,,kimmy922,-2,31,25,55%,56,2023/04/15
809,1100,,.,-3,16,15,52%,31,2023/04/08
810,1100,,Haze,-2,38,35,52%,73,2023/04/15
811,1100,,e s 0,+1,15,12,56%,27,2023/04/15
812,1100,,Kaisor,+3,32,25,56%,57,2023/04/17
813,1100,,Andrew999,-6,8,8,50%,16,2023/03/23
814,1099,,Sostradayu,+2,6,4,60%,10,2023/04/08
815,1099,,🞦 𝓖𝓗𝓞𝓢𝓣 🞦,-2,6,4,60%,10,2023/04/06
816,1099,,Magpie,+3,16,11,59%,27,2023/04/12
817,1099,,Ding Dong,+1,83,89,48%,172,2023/04/18
818,1099,,SmauGG,+1,19,16,54%,35,2023/04/14
819,1098,,Pain_Inside,+1,39,39,50%,78,2023/04/17
820,1098,,An.Ritter,+7,7,3,70%,10,2023/04/08
821,1098,,An.t,+2,52,36,59%,88,2023/03/28
822,1098,,Simped,+2,14,11,56%,25,2023/04/09
823,1098,,Four Friendly Brown Men,-1,22,15,59%,37,2023/04/16
824,1098,,Gus Fring,-5,76,77,50%,153,2023/04/13
825,1098,,No thank you!,+1,15,14,52%,29,2023/03/24
826,1098,,The Chemist,+4,8,5,62%,13,2023/03/31
827,1097,,PeterGriffin,+1,11,12,48%,23,2023/04/06
828,1097,,Loki,+3,13,8,62%,21,2023/04/09
829,1097,,Mandude,-3,8,4,67%,12,2023/04/05
830,1096,,Sir,+1,15,15,50%,30,2023/04/14
831,1096,,Drew-bert,-1,9,6,60%,15,2023/04/16
832,1096,,Blindscout,+1,19,14,58%,33,2023/03/26
833,1096,,Fowl,+2,11,8,58%,19,2023/03/21
834,1096,,DirtyDan,+2,28,25,53%,53,2023/04/08
835,1095,,SteFUN,-1,19,18,51%,37,2023/04/17
836,1095,,Soja,+2,13,9,59%,22,2023/04/01
837,1095,,POWERTOM,-2,21,19,53%,40,2023/04/16
838,1095,,Asno3030,+2,45,35,56%,80,2023/04/15
839,1094,,CXUNTA'S,+1,15,14,52%,29,2023/03/24
840,1094,,__C4m0ufl4gE-,+2,7,4,64%,11,2023/03/24
841,1093,,Jim Raynor,-3,32,24,57%,56,2023/04/07
842,1093,,Abu Jahn,-1,10,9,53%,19,2023/04/10
843,1092,,churchmf,-3,13,11,54%,24,2023/04/11
844,1092,,kakagaca,-1,15,11,58%,26,2023/04/11
845,1092,,zliiroii,-2,31,23,57%,54,2023/04/18
846,1091,,Rocket Shikadai Nara 長距離,+4,20,18,53%,38,2023/04/10
847,1091,,Ghoxxy,-2,7,5,58%,12,2023/03/31
848,1091,,Chairman Pan,-9,28,25,53%,53,2023/04/17
849,1091,,Jello,-3,36,34,51%,70,2023/04/11
850,1090,,Geforce,-4,9,8,53%,17,2023/04/03
851,1090,,-ScOuTmAn-,-2,7,5,58%,12,2023/04/13
852,1090,,小小戴1234,-3,13,12,52%,25,2023/04/16
853,1090,,MaTTi,+1,6,4,60%,10,2023/04/15
854,1090,,BulletToTheBrain,-3,6,6,50%,12,2023/04/05
855,1090,,Lergen,-1,9,6,60%,15,2023/04/09
856,1090,,Wind,+4,12,7,63%,19,2023/04/10
857,1090,,RANDY_JIM,-3,7,5,58%,12,2023/03/24
858,1090,,ModuGames,+2,29,26,53%,55,2023/03/21
859,1089,,Rebel Gizmo,-2,25,26,49%,51,2023/03/25
860,1089,,Squabbey,+1,11,9,55%,20,2023/03/24
861,1088,,Olg,+1,12,10,55%,22,2023/03/31
862,1088,,tictac,-1,10,7,59%,17,2023/04/13
863,1087,,Patrick,+2,25,22,53%,47,2023/04/14
864,1087,,Mantra,-4,10,11,48%,21,2023/04/06
865,1087,,Pharmacist,+2,17,17,50%,34,2023/04/16
866,1087,,Oskar,-5,38,32,54%,70,2023/04/03
867,1087,,OhptikNurv,-1,14,10,58%,24,2023/04/03
868,1087,,BadmanLarry,-2,68,71,49%,139,2023/04/07
869,1087,,AlterFritz,-5,15,13,54%,28,2023/04/17
870,1086,,Pintroll,-2,17,17,50%,34,2023/04/16
871,1086,,绮靡之音,-1,9,8,53%,17,2023/03/31
872,1086,,Briefcase Taco,+1,7,4,64%,11,2023/04/15
873,1086,,sukablayt,-1,26,17,60%,43,2023/04/15
874,1086,,ThePunkie,+1,8,7,53%,15,2023/04/12
875,1086,,War_Dolphin,+1,32,24,57%,56,2023/04/17
876,1086,,Imhuthep,+2,8,6,57%,14,2023/03/22
877,1086,,Cpt.Ray,-1,18,13,58%,31,2023/04/10
878,1086,,NivekQc,-2,16,15,52%,31,2023/04/05
879,1086,,7UziTotingMonkeys,+1,29,32,48%,61,2023/03/30
880,1086,,Daniel Gaming,+2,16,13,55%,29,2023/04/18
881,1086,,=KSK=Simon,+3,15,12,56%,27,2023/04/05
882,1086,,Webley's Webleys H20,+2,38,36,51%,74,2023/04/12
883,1085,,Zaney,+2,6,6,50%,12,2023/04/09
884,1085,,-BA- Syrisssamson,+2,8,6,57%,14,2023/03/28
885,1085,,FurioSS,+4,8,5,62%,13,2023/04/12
886,1085,,Superschmal,-1,7,5,58%,12,2023/04/07
887,1085,,brummbar boi,-2,6,4,60%,10,2023/04/02
888,1085,,TSu_frakas,+2,40,45,47%,85,2023/04/16
889,1085,,秋月レン| MP40,-1,37,31,54%,68,2023/04/10
890,1085,,Cyric Deadsoul,+1,6,4,60%,10,2023/03/27
891,1085,,Swan,-3,7,7,50%,14,2023/03/28
892,1085,,Chantier,+1,6,4,60%,10,2023/04/08
893,1085,,chiavinatorù,+1,7,4,64%,11,2023/03/22
894,1085,,Nemesis,+3,8,6,57%,14,2023/04/15
895,1085,,ADOLFO_CABRERA,-1,48,48,50%,96,2023/04/16
896,1085,,ljr8mmjg,+3,16,11,59%,27,2023/03/31
897,1084,,SzarywilkPL,-2,12,10,55%,22,2023/04/01
898,1084,,Kaiser Soze,+1,22,20,52%,42,2023/04/10
899,1084,,paradox13ox,-4,7,7,50%,14,2023/04/09
900,1084,,wdnmd,+2,20,20,50%,40,2023/04/17
901,1084,,Patrick,+2,10,9,53%,19,2023/04/04
902,1084,,o1word,+8,14,9,61%,23,2023/03/21
903,1084,,Silence,+2,14,10,58%,24,2023/04/14
904,1084,,nmk,-1,17,16,52%,33,2023/03/22
905,1083,,'sWiNgEz,+2,8,6,57%,14,2023/04/11
906,1083,,ad.,+1,10,6,63%,16,2023/04/05
907,1083,,The Real Green,+1,11,8,58%,19,2023/04/16
908,1082,,Selan,-2,47,42,53%,89,2023/04/14
909,1082,,Pin0kyo,+2,6,4,60%,10,2023/04/07
910,1082,,CAPTAINofPOLAND,-2,10,10,50%,20,2023/04/14
911,1082,,Pinhi,-1,7,5,58%,12,2023/04/17
912,1082,,DanteQuaylin,+1,31,32,49%,63,2023/04/08
913,1082,,AUT_LH,-1,12,10,55%,22,2023/04/15
914,1082,,Wuff,-5,10,11,48%,21,2023/03/30
915,1081,,H C H E L P M E,-3,90,81,53%,171,2023/04/14
916,1081,,空空大師,+2,8,7,53%,15,2023/04/01
917,1081,,Naschfuchs,-3,9,8,53%,17,2023/04/06
918,1081,,XenosHeresy,-2,27,19,59%,46,2023/04/14
919,1081,,Pottatow,+6,33,29,53%,62,2023/03/30
920,1080,,Jacob,-1,13,11,54%,24,2023/03/22
921,1080,,TimBurrito,+1,16,13,55%,29,2023/04/07
922,1080,,Ooged,-2,44,42,51%,86,2023/04/16
923,1080,,Bacon,-3,27,27,50%,54,2023/04/17
924,1080,,ThreeOracle,-1,26,26,50%,52,2023/04/10
925,1079,,伊卡洛斯,-1,14,11,56%,25,2023/04/15
926,1079,,Mivv,+3,5,5,50%,10,2023/03/22
927,1079,,rebom,-2,6,5,55%,11,2023/04/17
928,1078,,BunnyBlender,-2,6,4,60%,10,2023/03/25
929,1078,,Familie Ritter,+1,7,4,64%,11,2023/03/30
930,1078,,Laenir,+2,9,7,56%,16,2023/04/12
931,1078,,Asabel,+3,13,8,62%,21,2023/04/02
932,1078,,ouchouch,+1,11,10,52%,21,2023/04/02
933,1077,,NorthWestFresh,+4,90,95,49%,185,2023/04/16
934,1077,,JosephTheGreat,+2,14,11,56%,25,2023/03/30
935,1077,,Sushi Chef on Crack,+3,9,6,60%,15,2023/04/02
936,1076,,Aymes,+2,64,64,50%,128,2023/04/14
937,1076,,OP,-4,9,8,53%,17,2023/04/02
938,1076,,Kannamix,+3,34,33,51%,67,2023/04/17
939,1075,,Cash Finns,+1,8,6,57%,14,2023/04/10
940,1075,,schnuffeltuff (SOLU),+3,14,12,54%,26,2023/03/31
941,1075,,Lation_kasler,-1,7,5,58%,12,2023/04/14
942,1075,,SHALDUN,+1,13,10,57%,23,2023/03/26
943,1075,,eybe,-1,6,4,60%,10,2023/04/06
944,1075,,[IRS] EBass,+2,11,9,55%,20,2023/04/10
945,1075,,Increase,-2,25,22,53%,47,2023/04/11
946,1074,,Incinz,-1,14,12,54%,26,2023/04/10
947,1074,,HAN,+1,6,4,60%,10,2023/03/21
948,1074,,PoLarr,-1,6,4,60%,10,2023/03/31
949,1074,,SnooSnarry,-1,17,15,53%,32,2023/04/16
950,1074,,LinSir,+4,17,12,59%,29,2023/04/13
951,1073,,Adonis Creed,-2,16,14,53%,30,2023/04/10
952,1073,,CQQ,-2,37,32,54%,69,2023/04/17
953,1073,,EG_DirtyKen,-4,7,6,54%,13,2023/03/31
954,1073,,[DpS]Warlock,-3,21,23,48%,44,2023/04/15
955,1072,,flyingpancake,-1,14,12,54%,26,2023/04/01
956,1072,,Andrax,-2,32,34,48%,66,2023/04/17
957,1072,,Somedumbguy,+1,180,181,50%,361,2023/04/17
958,1072,,Cinder,+2,19,13,59%,32,2023/04/05
959,1072,,Draj,+3,16,14,53%,30,2023/04/02
960,1072,,Hydroxylpentanol,-2,11,9,55%,20,2023/04/13
961,1071,,Alexem,+5,9,7,56%,16,2023/04/16
962,1071,,Manchego Man,-2,6,5,55%,11,2023/04/08
963,1071,,Fallen Ghost,+2,9,8,53%,17,2023/04/01
964,1071,,MyFunction,-2,9,9,50%,18,2023/04/06
965,1071,,frehzii,-2,8,6,57%,14,2023/03/22
966,1071,,Panzer-Michl,+1,22,20,52%,42,2023/04/10
967,1071,,Demi,+2,26,20,57%,46,2023/04/02
968,1071,,JuliiG,-3,14,16,47%,30,2023/03/31
969,1070,,Rawke,-1,7,6,54%,13,2023/04/07
970,1070,,Potbelly Goblin Hunter,+1,10,8,56%,18,2023/04/02
971,1070,,grau,+1,7,5,58%,12,2023/04/15
972,1070,,yarang,-2,5,5,50%,10,2023/04/02
973,1069,,Larry Lobster,+1,12,11,52%,23,2023/04/15
974,1069,,Azely,+1,35,36,49%,71,2023/04/01
975,1069,,clepic42,+1,15,18,45%,33,2023/04/17
976,1069,,kongo-bongo,-1,14,15,48%,29,2023/04/16
977,1069,,jordanglez97,-1,28,28,50%,56,2023/04/11
978,1069,,Coastin,+1,9,8,53%,17,2023/04/02
979,1069,,Xtreme,+3,6,4,60%,10,2023/04/16
980,1069,,六文钱,-4,23,23,50%,46,2023/04/13
981,1069,,Rikkart,+1,34,30,53%,64,2023/04/17
982,1069,,Slipz,+3,15,13,54%,28,2023/04/15
983,1068,,Broodwich,+1,15,13,54%,28,2023/03/22
984,1068,,rain,+1,8,7,53%,15,2023/04/17
985,1068,,小青,-1,6,4,60%,10,2023/04/11
986,1068,,tediousgraffiti,-1,26,21,55%,47,2023/04/15
987,1068,,kaiz0r,+2,21,26,45%,47,2023/04/17
988,1068,,Megasalami,-1,9,9,50%,18,2023/04/17
989,1068,,🏹tȟogktékA🔪💀🪓,-1,37,37,50%,74,2023/04/06
990,1067,,Sir Lancelot,-1,9,8,53%,17,2023/03/26
991,1067,,HolySpoon,+5,10,10,50%,20,2023/03/28
992,1067,,Harlequin,-4,9,10,47%,19,2023/04/13
993,1067,,这是真的吗,+1,13,13,50%,26,2023/04/10
994,1067,,cadian,+1,11,9,55%,20,2023/03/24
995,1066,,Empty_Can,-1,105,105,50%,210,2023/04/17
996,1066,,Sojourner,-1,11,11,50%,22,2023/04/14
997,1066,,Sher,-1,32,28,53%,60,2023/04/12
998,1065,,le Régent,+1,36,30,55%,66,2023/03/28
999,1065,,Azza,-10,62,60,51%,122,2023/04/09
1000,1065,,Sir Toady,+1,15,12,56%,27,2023/04/17
1001,1065,,Shlomo Finkelstein,+4,14,9,61%,23,2023/04/14
1002,1065,,MoonLover138,+3,7,4,64%,11,2023/03/26
1003,1065,,Rolling9Deep,-3,9,9,50%,18,2023/03/28
1004,1064,,Sharpg,+1,18,20,47%,38,2023/04/10
1005,1064,,Liamx,-5,12,14,46%,26,2023/04/07
1006,1064,,Rakkammecc,-2,37,33,53%,70,2023/04/06
1007,1064,,TW sss40405,-5,11,12,48%,23,2023/04/08
1008,1064,,qqeet1223344,+1,7,6,54%,13,2023/04/17
1009,1064,,Super Ben,+1,12,10,55%,22,2023/04/05
1010,1064,,WhiteFlashReborn,+2,7,5,58%,12,2023/03/31
1011,1064,,irbo84,+1,100,97,51%,197,2023/04/17
1012,1064,,UndeadNinja,+2,7,5,58%,12,2023/04/02
1013,1063,,Brenz,-2,32,30,52%,62,2023/04/10
1014,1063,,BodenWaffe,+1,12,10,55%,22,2023/04/04
1015,1063,,sc3ada,+2,9,6,60%,15,2023/04/07
1016,1063,,Pariah,-3,39,39,50%,78,2023/04/01
1017,1063,,[DK] KrigerKris,+2,7,5,58%,12,2023/04/14
1018,1062,,AParanoidPeach,-1,13,12,52%,25,2023/04/17
1019,1062,,ShottaZ,+2,6,5,55%,11,2023/04/17
1020,1062,,Fookin' Laser Sights,+2,13,12,52%,25,2023/04/07
1021,1062,,Charles_XII,+1,27,20,57%,47,2023/04/17
1022,1061,,Vedro_32,+1,35,32,52%,67,2023/03/28
1023,1061,,Asdasfad.,-1,27,25,52%,52,2023/04/13
1024,1061,,Jango,+1,12,15,44%,27,2023/04/06
1025,1061,,Hagen,-1,20,16,56%,36,2023/04/03
1026,1061,,Gangsta101G,-1,14,13,52%,27,2023/03/26
1027,1061,,Riva,-2,45,42,52%,87,2023/03/29
1028,1061,,锅连长,+1,8,7,53%,15,2023/04/11
1029,1061,,Brotherhood of noob,+1,10,10,50%,20,2023/03/29
1030,1060,,Dirty D,+1,10,9,53%,19,2023/03/29
1031,1060,,SmeltedElk,+2,8,9,47%,17,2023/04/15
1032,1060,,SunTzu,+4,43,45,49%,88,2023/04/17
1033,1060,,DPJ_realy,-1,13,14,48%,27,2023/04/16
1034,1059,,Jeffason el boxon,-1,11,10,52%,21,2023/03/29
1035,1059,,Sophia,+8,18,13,58%,31,2023/03/29
1036,1059,,HOKAGE,+1,6,5,55%,11,2023/04/07
1037,1059,,[-RO-] Solomonarul,-1,85,89,49%,174,2023/04/17
1038,1059,,Nevraths,-1,74,71,51%,145,2023/04/15
1039,1059,,Dejaded,+4,11,8,58%,19,2023/04/10
1040,1059,,gepetto,-1,6,4,60%,10,2023/03/23
1041,1059,,Rankstar,+2,22,17,56%,39,2023/03/30
1042,1059,,Twitch.tv/DirtyKar1,+1,31,29,52%,60,2023/04/15
1043,1059,,Boss Of This Gym,+9,34,22,61%,56,2023/04/06
1044,1058,,Willyto,+5,19,14,58%,33,2023/04/17
1045,1058,,Crow,-3,26,28,48%,54,2023/04/08
1046,1058,,SNENS,+1,29,29,50%,58,2023/04/08
1047,1058,,Heizenberg,+2,26,19,58%,45,2023/04/16
1048,1058,,fefsan,+1,24,20,55%,44,2023/04/10
1049,1058,,Penger,+1,42,40,51%,82,2023/04/10
1050,1057,,D O M I N A T E,-4,21,22,49%,43,2023/04/01
1051,1057,,twitchtvflekz127,-7,200,196,51%,396,2023/04/17
1052,1057,,Sujy,-3,20,23,47%,43,2023/04/12
1053,1057,,Hepa,+3,13,10,57%,23,2023/04/17
1054,1057,,Till Forever Falls Apart,-1,35,26,57%,61,2023/04/05
1055,1056,,Flint_Beastwood,+3,14,14,50%,28,2023/04/14
1056,1056,,PrinzIgor,-3,42,39,52%,81,2023/04/15
1057,1055,,Blarg_Master,-1,8,8,50%,16,2023/04/07
1058,1055,,The Dude,+2,17,14,55%,31,2023/03/25
1059,1055,,In It For The Hats,-2,30,29,51%,59,2023/04/17
1060,1055,,子龙英雄连2,+5,31,29,52%,60,2023/04/17
1061,1055,,Interesting...,-1,10,9,53%,19,2023/03/27
1062,1055,,Josh,-1,11,10,52%,21,2023/03/24
1063,1054,,Eagleheart21,-3,8,8,50%,16,2023/04/08
1064,1054,,BortekThePigeon,+2,6,5,55%,11,2023/04/13
1065,1054,,UnnaStrich,-1,6,5,55%,11,2023/04/10
1066,1054,,frogfucker,-3,21,17,55%,38,2023/04/17
1067,1054,,I_Lov_Anime_Titties,-1,23,18,56%,41,2023/04/06
1068,1054,,Vouzlez vous prende en cafe avec,-3,7,7,50%,14,2023/04/07
1069,1053,,acefromspace,-1,13,12,52%,25,2023/04/12
1070,1053,,Marius,+1,17,13,57%,30,2023/04/08
1071,1053,,Mr.Alex97,-3,5,5,50%,10,2023/04/17
1072,1053,,johny247trace,-2,26,20,57%,46,2023/04/07
1073,1053,,Likes,-2,9,9,50%,18,2023/04/01
1074,1053,,ironicusername17,-2,23,19,55%,42,2023/04/14
1075,1053,,Game-Go,-2,31,30,51%,61,2023/04/17
1076,1053,,Holy,-2,83,80,51%,163,2023/04/08
1077,1053,,J.,+2,6,5,55%,11,2023/04/01
1078,1053,,Razor34,-1,10,10,50%,20,2023/04/10
1079,1053,,Frau Holle,+5,50,45,53%,95,2023/04/17
1080,1052,,米勒上尉★John millers.us,+2,66,69,49%,135,2023/03/26
1081,1052,,Psychomantis.PANG,-1,15,14,52%,29,2023/04/17
1082,1052,,crizzy218,+1,17,17,50%,34,2023/04/16
1083,1052,,Exodiac,-2,10,14,42%,24,2023/03/31
1084,1052,,WHAT,-1,5,5,50%,10,2023/04/17
1085,1052,,General Feldsalat,+1,37,37,50%,74,2023/03/30
1086,1052,,MahnGiL,-1,9,9,50%,18,2023/04/16
1087,1051,,Walkerthon,+5,21,23,48%,44,2023/04/11
1088,1051,,Obersoldat,-1,8,7,53%,15,2023/04/14
1089,1051,,LanceBenz,-2,12,12,50%,24,2023/04/02
1090,1051,,Java,+2,5,5,50%,10,2023/03/30
1091,1051,,Wüstenschubs,+1,7,7,50%,14,2023/04/02
1092,1051,,Endless Pera,-2,5,5,50%,10,2023/04/17
1093,1051,,Ramen the Desert Noodle,+4,7,6,54%,13,2023/04/16
1094,1051,,李晴天,-1,24,18,57%,42,2023/04/17
1095,1050,,够得到的钟摆,-2,13,16,45%,29,2023/04/09
1096,1050,,spz,-6,24,22,52%,46,2023/04/16
1097,1050,,jopeka,-1,11,7,61%,18,2023/04/17
1098,1050,,Animal,+2,5,6,45%,11,2023/04/12
1099,1050,,Heffay'R,+1,6,4,60%,10,2023/04/02
1100,1050,,Mephswall,+3,14,11,56%,25,2023/04/15
1101,1050,,BANZAI,-1,6,4,60%,10,2023/04/16
1102,1049,,PolanStronk,-1,15,12,56%,27,2023/03/24
1103,1049,,Senator Armstrong,+3,18,16,53%,34,2023/04/17
1104,1049,,Esdra,-2,6,6,50%,12,2023/04/12
1105,1049,,noluckystrike,-3,5,5,50%,10,2023/04/02
1106,1049,,Nacho Fan Sandy Ravage,-1,18,16,53%,34,2023/04/10
1107,1048,,Blamo,+2,6,4,60%,10,2023/03/30
1108,1048,,Enlightened Enlisted,-1,12,9,57%,21,2023/03/24
1109,1048,,A$C0R,-3,10,10,50%,20,2023/03/31
1110,1048,,SquishyMuffin,-3,8,8,50%,16,2023/04/10
1111,1048,,Kronkers,+2,14,11,56%,25,2023/04/06
1112,1048,,KingSeamus,-1,24,20,55%,44,2023/03/30
1113,1048,,Cen,+1,11,11,50%,22,2023/04/04
1114,1048,,LuckiLuke,-3,8,8,50%,16,2023/04/01
1115,1047,,RaBBBio^,+3,10,9,53%,19,2023/04/17
1116,1047,,JinkelaBoss,-1,7,6,54%,13,2023/04/17
1117,1047,,nass1,+1,7,7,50%,14,2023/04/09
1118,1047,,Effecto,-1,35,34,51%,69,2023/04/16
1119,1047,,Bezukhov,+1,39,36,52%,75,2023/04/17
1120,1047,,BrockSamson,-1,11,9,55%,20,2023/03/31
1121,1047,,The M.,-5,59,62,49%,121,2023/03/26
1122,1046,,HubStub,+1,6,5,55%,11,2023/04/17
1123,1046,,House,+2,6,5,55%,11,2023/04/04
1124,1046,,Bobtinator,+5,8,6,57%,14,2023/04/18
1125,1046,,EVILUTION,-2,8,9,47%,17,2023/04/14
1126,1046,,slowny,+1,12,10,55%,22,2023/03/26
1127,1046,,Froziik,+1,35,38,48%,73,2023/04/16
1128,1046,,Benin,-3,9,9,50%,18,2023/04/02
1129,1045,,Luziefer,-2,9,10,47%,19,2023/04/13
1130,1045,,darkyBRO,-3,66,68,49%,134,2023/04/15
1131,1045,,Arashenstein,-1,7,5,58%,12,2023/04/17
1132,1045,,菁松老大,-1,17,15,53%,32,2023/03/26
1133,1045,,CryptX,+2,7,6,54%,13,2023/04/02
1134,1044,,这电脑有毒,+2,76,71,52%,147,2023/04/03
1135,1044,,Jingle,-7,10,18,36%,28,2023/04/09
1136,1044,,Snoopy,-1,17,16,52%,33,2023/03/27
1137,1044,,諾爾斯,+1,6,4,60%,10,2023/04/02
1138,1044,,WilliG,-3,6,6,50%,12,2023/04/02
1139,1044,,maxxximka0,-1,43,46,48%,89,2023/04/13
1140,1044,,Smokezound,-1,20,17,54%,37,2023/04/13
1141,1044,,Mystogan,+1,26,27,49%,53,2023/04/17
1142,1044,,실망하지않을게,+1,14,13,52%,27,2023/04/12
1143,1043,,Calxtus,+2,26,33,44%,59,2023/03/31
1144,1043,,SweetConnection,-2,6,6,50%,12,2023/04/02
1145,1043,,Tc||Driven2Chonk,-1,17,17,50%,34,2023/03/27
1146,1043,,SovietBuffalo,+2,18,14,56%,32,2023/04/16
1147,1043,,Vichunt_st,+2,6,6,50%,12,2023/04/15
1148,1043,,Bad.Commissar,+2,18,15,55%,33,2023/04/08
1149,1042,,Aikano,+2,10,8,56%,18,2023/03/31
1150,1042,,Kit Fisto,+1,13,13,50%,26,2023/04/16
1151,1042,,minty,-1,27,24,53%,51,2023/03/27
1152,1042,,fary2,-1,59,59,50%,118,2023/04/13
1153,1042,,Boca Del Lobo,+1,23,24,49%,47,2023/04/16
1154,1042,,Master_Baiter,+1,9,8,53%,17,2023/03/31
1155,1041,,Snowy,+1,13,12,52%,25,2023/04/17
1156,1041,,tangojuliett,-1,11,10,52%,21,2023/04/17
1157,1041,,ふゆき,+3,6,7,46%,13,2023/04/06
1158,1041,,{Martin},-1,6,5,55%,11,2023/04/16
1159,1041,,rabbeat,+2,6,4,60%,10,2023/04/01
1160,1041,,Light,-1,6,5,55%,11,2023/04/01
1161,1041,,FAKE,-2,6,6,50%,12,2023/04/17
1162,1040,,Cybersiggi,+1,7,6,54%,13,2023/04/02
1163,1040,,L. Vorenus,-1,11,11,50%,22,2023/04/16
1164,1040,,Rancid,-1,6,4,60%,10,2023/03/24
1165,1040,,蜻蜓队长,+1,65,61,52%,126,2023/04/17
1166,1040,,Hawkkinson,+1,6,6,50%,12,2023/04/01
1167,1040,,周子鹤,-1,23,20,53%,43,2023/04/15
1168,1040,,Ranger1408,+3,6,5,55%,11,2023/04/09
1169,1040,,James Bond,-1,29,24,55%,53,2023/04/05
1170,1039,,MindfulRaptor,+3,7,7,50%,14,2023/04/09
1171,1039,,weizen.nilas,-2,52,55,49%,107,2023/04/16
1172,1039,,Fat Samurai,+1,6,4,60%,10,2023/04/05
1173,1039,,DunkleBill,+3,7,7,50%,14,2023/04/07
1174,1039,,Phillip II - Wardaddy,+5,25,19,57%,44,2023/04/16
1175,1038,,passon16,-1,9,8,53%,17,2023/04/11
1176,1038,,Affenlord,-1,5,5,50%,10,2023/04/04
1177,1038,,zoi,+1,17,15,53%,32,2023/04/16
1178,1038,,leonidas,+1,13,13,50%,26,2023/04/17
1179,1038,,tanne455,-2,29,29,50%,58,2023/04/08
1180,1038,,CatInBox,-2,16,21,43%,37,2023/04/05
1181,1038,,DeathBringeR,-1,39,35,53%,74,2023/04/17
1182,1038,,el menda lerenda,-3,10,9,53%,19,2023/04/04
1183,1038,,DouYu3438914_扶扶,+3,22,21,51%,43,2023/04/14
1184,1037,,BlackieChan,+3,26,20,57%,46,2023/03/31
1185,1037,,WolfIkaz,+1,19,19,50%,38,2023/04/06
1186,1037,,ioio,+2,143,138,51%,281,2023/04/18
1187,1037,,MAZA_(Rus),+4,11,9,55%,20,2023/04/16
1188,1037,,BHPGuRuAon,-1,33,29,53%,62,2023/04/15
1189,1037,,der mit der Mundmaus,-4,9,11,45%,20,2023/03/30
1190,1037,,S1train,-1,7,6,54%,13,2023/04/03
1191,1037,,Grävlingen Åke,+1,13,13,50%,26,2023/04/13
1192,1037,,Johnny Rico,-1,6,6,50%,12,2023/03/21
1193,1037,,Myrn,+1,12,10,55%,22,2023/04/15
1194,1036,,ftfuvi,-1,11,9,55%,20,2023/04/03
1195,1036,,Mr.Drix,-2,26,22,54%,48,2023/03/21
1196,1036,,Bullomas,+1,20,21,49%,41,2023/04/10
1197,1036,,Lemonrocks1,+1,11,10,52%,21,2023/04/02
1198,1036,,PaPaCrazy,-5,5,6,45%,11,2023/04/05
1199,1036,,Haja,+1,9,7,56%,16,2023/03/31
1200,1036,,ShooterWorld,-5,11,12,48%,23,2023/04/07
1201,1035,,NJMonakil,+1,7,7,50%,14,2023/04/08
1202,1035,,Dan,-1,7,8,47%,15,2023/04/17
1203,1035,,IVAR TB,+1,13,12,52%,25,2023/04/14
1204,1035,,Thandari,-1,80,84,49%,164,2023/03/31
1205,1035,,Patchouli Knowledge,-1,11,12,48%,23,2023/03/27
1206,1034,,yiitcan666,+1,11,7,61%,18,2023/04/04
1207,1034,,da.zigounet,+1,56,60,48%,116,2023/04/17
1208,1034,,cetfisch,+2,7,8,47%,15,2023/03/25
1209,1034,,камазик,-2,70,66,51%,136,2023/04/17
1210,1034,,sebiprofi,-4,6,7,46%,13,2023/03/26
1211,1034,,valentijn,-1,5,5,50%,10,2023/04/16
1212,1034,,Fresh_Mint,+2,8,8,50%,16,2023/04/01
1213,1034,,marcmorn,-2,7,7,50%,14,2023/03/24
1214,1033,,erectusapes,+2,20,23,47%,43,2023/04/16
1215,1033,,Kenan,-2,5,5,50%,10,2023/04/07
1216,1033,,[CHUD] Some Pig,-1,64,57,53%,121,2023/04/06
1217,1033,,Rex Everything,+1,7,6,54%,13,2023/04/07
1218,1033,,Knakkegaard,-1,6,6,50%,12,2023/04/05
1219,1033,,cancerrob,-1,6,4,60%,10,2023/03/31
1220,1032,,iswtiger,-3,17,19,47%,36,2023/04/12
1221,1032,,EXP,+1,8,7,53%,15,2023/04/12
1222,1032,,SulumEi,-2,6,6,50%,12,2023/04/09
1223,1032,,n1c,-1,18,17,51%,35,2023/04/09
1224,1031,,Morcovi,+1,11,9,55%,20,2023/04/10
1225,1031,,disco,-2,6,7,46%,13,2023/04/04
1226,1031,,Pyne Styx,-5,9,9,50%,18,2023/04/16
1227,1031,,Demigore,-1,8,9,47%,17,2023/04/13
1228,1031,,Carne,-1,32,30,52%,62,2023/04/04
1229,1031,,狂奔的海螺,+1,12,11,52%,23,2023/04/17
1230,1031,,WilliamTang,+3,16,12,57%,28,2023/04/12
1231,1031,,Slîn,-2,5,5,50%,10,2023/03/25
1232,1030,,lakerss,-1,106,112,49%,218,2023/04/17
1233,1030,,Phill10,+2,9,9,50%,18,2023/04/08
1234,1030,,sirota,-2,33,34,49%,67,2023/04/16
1235,1030,,Voodoo Mama JuJu,-1,14,13,52%,27,2023/04/17
1236,1030,,TisSirTony,-1,35,33,51%,68,2023/04/05
1237,1030,,lappodamy,+1,25,29,46%,54,2023/04/17
1238,1029,,Daddy Chill,-1,11,9,55%,20,2023/04/17
1239,1029,,Remofire ♛,-5,11,11,50%,22,2023/03/31
1240,1029,,Howdenn,-1,12,9,57%,21,2023/04/06
1241,1029,,oilcolors,-2,7,6,54%,13,2023/03/26
1242,1029,,Wayne_Wang,-3,8,9,47%,17,2023/04/11
1243,1029,,UncleSpam®,+1,6,7,46%,13,2023/04/04
1244,1029,,MrGiio98,-2,17,16,52%,33,2023/04/16
1245,1028,,Datt-xD,+1,5,5,50%,10,2023/03/25
1246,1028,,ELPROLO,-1,98,103,49%,201,2023/04/01
1247,1028,,aero,+1,7,7,50%,14,2023/04/15
1248,1028,,MacAlbert,+1,6,6,50%,12,2023/04/15
1249,1028,,i just stupid korean,+1,12,10,55%,22,2023/04/12
1250,1028,,Stormboy81,+1,7,6,54%,13,2023/04/10
1251,1028,,bubahey,-2,16,17,48%,33,2023/03/28
1252,1028,,kaigem43,+1,38,35,52%,73,2023/04/10
1253,1028,,Hemera.Helio,-2,6,7,46%,13,2023/03/24
1254,1028,,zyk1999,+2,37,32,54%,69,2023/04/16
1255,1027,,Aurora,+2,27,23,54%,50,2023/04/17
1256,1027,,iBaker,-2,24,25,49%,49,2023/04/16
1257,1027,,"Butts, Butts Everywhere",-1,43,38,53%,81,2023/04/14
1258,1027,,WC206,-3,9,11,45%,20,2023/04/15
1259,1027,,xuliang16879,+2,13,12,52%,25,2023/03/22
1260,1027,,Octavius Rex,+1,26,29,47%,55,2023/04/12
1261,1027,,M A L,+4,77,80,49%,157,2023/04/17
1262,1026,,Dreamerpython,+2,11,12,48%,23,2023/03/29
1263,1026,,Humiyuppie,+2,8,6,57%,14,2023/04/12
1264,1026,,Al_Ka_Pwn,-2,118,124,49%,242,2023/04/09
1265,1026,,vallinoranor,-4,5,5,50%,10,2023/04/06
1266,1025,,kotxebomba007,-2,7,7,50%,14,2023/04/17
1267,1025,,Bobblehead,+4,32,30,52%,62,2023/04/15
1268,1025,,Mini_Munchkin,-4,6,8,43%,14,2023/04/17
1269,1025,,Stringular,-4,15,19,44%,34,2023/04/09
1270,1025,,Fidel Cashflow,-2,19,15,56%,34,2023/04/13
1271,1024,,Psychotron,+3,28,34,45%,62,2023/04/17
1272,1024,,IxEuphoricxI,+4,6,4,60%,10,2023/04/16
1273,1024,,NSFW ` Sweaty AF,-1,8,10,44%,18,2023/04/06
1274,1024,,john.voyage,-1,13,14,48%,27,2023/04/07
1275,1024,,Clavius,-3,6,6,50%,12,2023/04/06
1276,1023,,BrawkSolid,-1,6,5,55%,11,2023/04/07
1277,1023,,pyromaniac,-2,8,9,47%,17,2023/04/05
1278,1023,,Smartie,-2,7,8,47%,15,2023/04/16
1279,1023,,Kewell_xu,+2,38,38,50%,76,2023/04/15
1280,1023,,FuelTank,-2,30,29,51%,59,2023/04/15
1281,1022,,jc5776,+2,16,14,53%,30,2023/04/12
1282,1022,,Luipaard,+3,13,10,57%,23,2023/04/05
1283,1022,,Tango,+1,17,18,49%,35,2023/04/03
1284,1022,,hanzelwaffen,+1,5,5,50%,10,2023/04/16
1285,1022,,Quasar,-1,18,15,55%,33,2023/04/12
1286,1022,,Dur3X,-1,10,8,56%,18,2023/04/10
1287,1021,,Jono,-3,7,10,41%,17,2023/04/17
1288,1021,,0olong,+3,7,7,50%,14,2023/04/03
1289,1021,,Bullenspitzel,-4,9,9,50%,18,2023/04/17
1290,1021,,nippy,-3,10,9,53%,19,2023/04/13
1291,1021,,sprexnico,-4,6,9,40%,15,2023/04/15
1292,1020,,Soppe S,+1,6,6,50%,12,2023/04/17
1293,1020,,gunruth234,+3,5,5,50%,10,2023/04/04
1294,1020,,Makrellen,+1,17,18,49%,35,2023/04/05
1295,1020,,Mister A.K.,-3,61,66,48%,127,2023/04/13
1296,1020,,Fantyx,-1,8,7,53%,15,2023/03/31
1297,1020,,KampfLachs,+1,25,28,47%,53,2023/04/17
1298,1020,,chris nos,+3,15,15,50%,30,2023/04/17
1299,1020,,holzbeinmanu,-1,6,5,55%,11,2023/04/06
1300,1020,,bugs bunny,+1,10,9,53%,19,2023/03/29
1301,1019,,Old Rebel,+1,18,18,50%,36,2023/03/31
1302,1019,,BluePiglet,+3,18,17,51%,35,2023/03/22
1303,1019,,Atet,-2,5,5,50%,10,2023/03/22
1304,1019,,MattJeburt,+1,10,10,50%,20,2023/04/04
1305,1019,,Gotthirsch,-2,7,9,44%,16,2023/04/10
1306,1019,,Mister Ju-Ju,-2,5,6,45%,11,2023/04/13
1307,1019,,RogueTrooper34,-4,16,17,48%,33,2023/04/06
1308,1018,,Kamikaze-Kurt,+1,11,9,55%,20,2023/04/06
1309,1018,,Ameer.Warrak,-1,8,6,57%,14,2023/04/17
1310,1018,,TRx,-1,66,77,46%,143,2023/04/13
1311,1018,,Ic3 4Z4D,-1,36,43,46%,79,2023/04/15
1312,1018,,GilGalad,-2,5,5,50%,10,2023/03/31
1313,1018,,perplexer,-2,35,33,51%,68,2023/04/16
1314,1018,,Longinus69,-3,15,10,60%,25,2023/04/04
1315,1018,,aurri,-2,10,8,56%,18,2023/04/10
1316,1018,,pellec,-1,12,11,52%,23,2023/04/11
1317,1017,,Professor,-1,6,5,55%,11,2023/04/06
1318,1017,,StyX,-3,5,5,50%,10,2023/03/24
1319,1017,,patteon,-1,23,25,48%,48,2023/04/03
1320,1016,,goldngoy,+1,7,6,54%,13,2023/04/04
1321,1016,,help,+1,6,6,50%,12,2023/03/23
1322,1016,,Hupsaiya,-2,19,19,50%,38,2023/04/10
1323,1015,,Insky,+2,6,5,55%,11,2023/04/10
1324,1015,,Vaits,-1,8,7,53%,15,2023/04/10
1325,1015,,Commissar500,-1,6,7,46%,13,2023/04/17
1326,1015,,Teelicht,-3,10,14,42%,24,2023/04/15
1327,1015,,Pero,+2,7,6,54%,13,2023/04/11
1328,1015,,EastHawk,-5,70,73,49%,143,2023/04/18
1329,1015,,XrusTim,+1,42,40,51%,82,2023/04/17
1330,1014,,snekasan,-5,18,22,45%,40,2023/04/17
1331,1014,,Ace D. Brokenwing,+2,6,6,50%,12,2023/04/12
1332,1014,,OldRacoon,+2,28,28,50%,56,2023/04/04
1333,1014,,Vokka,+2,4,6,40%,10,2023/04/01
1334,1014,,thaNästy,+3,23,22,51%,45,2023/04/02
1335,1014,,MR.DOGO-YT,-2,14,13,52%,27,2023/04/17
1336,1014,,Diesel,-5,28,29,49%,57,2023/04/17
1337,1014,,JellyMarine,+1,18,17,51%,35,2023/03/26
1338,1013,,Hulkster,-3,5,6,45%,11,2023/04/08
1339,1013,,DogGod,+1,15,22,41%,37,2023/03/29
1340,1013,,Bland Unicorn,-3,12,13,48%,25,2023/03/27
1341,1013,,D3kay,-1,76,76,50%,152,2023/04/12
1342,1013,,Armitron130,-1,16,14,53%,30,2023/03/25
1343,1013,,Consider the Coconut,-1,7,7,50%,14,2023/04/17
1344,1013,,Ferdie,-1,25,26,49%,51,2023/04/14
1345,1012,,Genius Malignus,+1,8,10,44%,18,2023/04/10
1346,1012,,Pastor Pres,+2,30,25,55%,55,2023/04/18
1347,1012,,AlphaOmega,-3,7,6,54%,13,2023/04/06
1348,1012,,Pjot,-4,11,12,48%,23,2023/04/15
1349,1012,,MonKeY,-2,15,14,52%,29,2023/04/16
1350,1012,,SlapInferno,-1,5,5,50%,10,2023/04/03
1351,1012,,MO,+4,19,18,51%,37,2023/04/02
1352,1012,,Berkilius,-3,10,12,45%,22,2023/04/17
1353,1012,,profpwn,+2,6,6,50%,12,2023/04/06
1354,1012,,birdhouse,+1,10,10,50%,20,2023/04/01
1355,1012,,Neuromancer,+1,10,9,53%,19,2023/04/15
1356,1012,,Chuggz,-1,12,14,46%,26,2023/03/30
1357,1012,,MrBust,+1,15,16,48%,31,2023/04/04
1358,1011,,Don Bowdenoli,+1,5,6,45%,11,2023/04/16
1359,1011,,Werido,+1,10,12,45%,22,2023/03/24
1360,1011,,Gefreiter Reiter,+4,13,10,57%,23,2023/04/09
1361,1011,,GvardiA,+2,57,61,48%,118,2023/04/17
1362,1011,,zwiggum,-1,6,6,50%,12,2023/04/17
1363,1011,,Thunder Strike,+2,6,5,55%,11,2023/04/09
1364,1011,,Gator,-1,6,5,55%,11,2023/04/09
1365,1011,,Mars,-2,8,8,50%,16,2023/04/07
1366,1011,,Robin Fjodorov,+1,8,8,50%,16,2023/04/08
1367,1010,,(⊙o⊙)…,+1,28,28,50%,56,2023/04/15
1368,1010,,HeldohneNamen,-1,8,8,50%,16,2023/04/06
1369,1010,,ˇ7ˇ*Romel-Panzer-Division*,+1,9,10,47%,19,2023/04/05
1370,1010,,Silverstatic,-1,13,11,54%,24,2023/03/23
1371,1010,,Imagodei,+4,11,9,55%,20,2023/04/14
1372,1010,,testing,+4,20,21,49%,41,2023/04/10
1373,1010,,sorlov,+1,6,6,50%,12,2023/04/08
1374,1010,,[DLB] Wolfen,-2,32,34,48%,66,2023/04/01
1375,1009,,88jpmm,+3,48,50,49%,98,2023/04/10
1376,1009,,m.walinski,-1,16,18,47%,34,2023/03/24
1377,1009,,ThatTwix,-1,13,13,50%,26,2023/03/21
1378,1009,,TumulousBread73,-1,27,21,56%,48,2023/04/17
1379,1009,,BugSplat,-1,7,7,50%,14,2023/04/14
1380,1009,,XQC,+2,10,11,48%,21,2023/04/12
1381,1008,,Cynec,+5,10,7,59%,17,2023/03/30
1382,1008,,Dunce Gollum,-2,15,15,50%,30,2023/04/16
1383,1008,,Maverick_1404,+1,7,7,50%,14,2023/04/06
1384,1008,,JINGER,-1,17,19,47%,36,2023/04/09
1385,1008,,ryuklikesapples,-1,8,8,50%,16,2023/03/28
1386,1008,,ロム Ram & Rom ラム,+2,6,6,50%,12,2023/04/09
1387,1008,,Deathmatch,+3,25,23,52%,48,2023/04/10
1388,1008,,Leonel,-1,13,11,54%,24,2023/04/15
1389,1008,,NachoVidanal,+2,46,48,49%,94,2023/03/27
1390,1008,,Capt.Photon,+1,7,7,50%,14,2023/04/16
1391,1008,,Fatefullemons,-3,5,7,42%,12,2023/04/05
1392,1008,,King Frustrated,-1,22,20,52%,42,2023/04/03
1393,1007,,rocketpossum,+1,21,23,48%,44,2023/04/16
1394,1007,,XaWeN,+2,20,20,50%,40,2023/04/07
1395,1007,,∑ⓔ딸긔맛공듀♡™,-1,11,11,50%,22,2023/03/29
1396,1007,,Breezey,-1,16,19,46%,35,2023/04/17
1397,1007,,SteveMcQueef,-2,6,7,46%,13,2023/04/02
1398,1006,,dascowman,-1,10,10,50%,20,2023/04/09
1399,1006,,四轮车,-3,16,14,53%,30,2023/04/05
1400,1006,,Nikko Nikko Niiiiii,-9,7,10,41%,17,2023/03/22
1401,1006,,Von Krieg,-1,66,71,48%,137,2023/04/17
1402,1006,,Diogenes,+1,6,8,43%,14,2023/03/27
1403,1006,,pwnosaurus,+1,5,6,45%,11,2023/04/10
1404,1006,,The_Buccaneer,+3,13,13,50%,26,2023/04/17
1405,1005,,aleX ツ,-5,6,7,46%,13,2023/03/28
1406,1005,,Че,+10,25,24,51%,49,2023/03/30
1407,1005,,The Anti-Liberal,-1,18,18,50%,36,2023/04/03
1408,1005,,Williams,+2,26,24,52%,50,2023/04/13
1409,1004,,mkaye,+1,14,11,56%,25,2023/04/15
1410,1004,,Awesome!,-1,12,15,44%,27,2023/04/09
1411,1004,,WayTooTicklish,-4,23,19,55%,42,2023/03/30
1412,1004,,SmoothieOutOfGoofy,+5,13,10,57%,23,2023/04/17
1413,1004,,Handsome Jack,+1,23,18,56%,41,2023/04/17
1414,1004,,Crunch,+1,12,11,52%,23,2023/04/02
1415,1004,,Micro,-1,14,13,52%,27,2023/04/12
1416,1004,,Rahan,+1,9,9,50%,18,2023/04/16
1417,1003,,Eagle_One,-2,18,21,46%,39,2023/03/23
1418,1003,,Brink,-2,10,12,45%,22,2023/04/07
1419,1003,,dmitrippp,-1,14,14,50%,28,2023/04/07
1420,1003,,unicorn,-1,7,6,54%,13,2023/03/31
1421,1003,,Winter,-1,8,9,47%,17,2023/03/31
1422,1002,,Smokindro420,+2,7,6,54%,13,2023/04/05
1423,1002,,Mathaus,+1,14,16,47%,30,2023/04/01
1424,1002,,Gorka,-3,7,9,44%,16,2023/03/23
1425,1002,,KG,+6,12,12,50%,24,2023/04/17
1426,1002,,YzY,+1,8,7,53%,15,2023/04/09
1427,1001,,ArmhairGeneral,-1,16,15,52%,31,2023/03/25
1428,1001,,Victorforce Alpha,+3,8,7,53%,15,2023/04/13
1429,1001,,Kingkong,+2,24,24,50%,48,2023/04/02
1430,1001,,Shup,-2,12,14,46%,26,2023/04/07
1431,1001,,Flower,+1,35,42,45%,77,2023/04/15
1432,1001,,Humba,-1,18,15,55%,33,2023/04/02
1433,1001,,Wahuhi,+1,13,13,50%,26,2023/04/08
1434,1000,,DEKA,-1,5,7,42%,12,2023/04/16
1435,1000,,Vodpalto,+5,8,8,50%,16,2023/04/10
1436,1000,,Gamer Girl 2k7,+4,6,5,55%,11,2023/04/01
1437,1000,,Josef Ballin',+1,7,7,50%,14,2023/03/27
1438,1000,,dikl2001,-1,8,9,47%,17,2023/04/01
1439,1000,,Lowang,-1,9,9,50%,18,2023/03/27
1440,1000,,Azildrake,+1,46,48,49%,94,2023/04/17
1441,999,,Feier,+1,6,6,50%,12,2023/04/16
1442,999,,ryad1,+1,29,30,49%,59,2023/04/11
1443,999,,Hans,+1,9,9,50%,18,2023/04/07
1444,999,,maettolae,-1,14,14,50%,28,2023/03/29
1445,999,,{-.{-.{ Ur Mom }.-}.-},+2,6,6,50%,12,2023/04/07
1446,999,,Tibu,-2,14,16,47%,30,2023/04/06
1447,999,,Butter0185,+1,41,41,50%,82,2023/04/11
1448,999,,sailor,-1,5,5,50%,10,2023/03/21
1449,998,,Big Yellow,+2,9,8,53%,17,2023/04/17
1450,998,,Disi,-1,10,13,43%,23,2023/03/31
1451,998,,Disi,-1,10,13,43%,23,2023/03/31
1452,998,,PotentialofGames,-1,24,26,48%,50,2023/04/17
1453,998,,Dogking,-3,15,20,43%,35,2023/04/15
1454,998,,Defender,-1,8,7,53%,15,2023/03/26
1455,998,,THE_FAB,-5,20,27,43%,47,2023/03/31
1456,998,,cadlab,-1,18,18,50%,36,2023/04/04
1457,998,,BMac,+1,12,15,44%,27,2023/04/06
1458,998,,blu75mobil,-1,5,6,45%,11,2023/03/26
1459,998,,Louis_XJ,+2,11,9,55%,20,2023/04/17
1460,998,,Zuntew...,-3,4,6,40%,10,2023/04/16
1461,998,,zzqhax,-4,13,12,52%,25,2023/04/16
1462,997,,klop1324,+1,6,5,55%,11,2023/04/13
1463,997,,Tachales_TTV,+2,9,8,53%,17,2023/03/24
1464,997,,Major Gladouze,-4,9,10,47%,19,2023/04/09
1465,997,,Timeh,-2,6,7,46%,13,2023/04/17
1466,997,,Seb.,-3,16,15,52%,31,2023/04/10
1467,997,,tomthecamel2093,-1,8,8,50%,16,2023/04/15
1468,997,,TTONAK,-6,8,10,44%,18,2023/04/07
1469,997,,Bademester,-1,10,11,48%,21,2023/04/11
1470,997,,phisonkwan,+2,11,11,50%,22,2023/04/10
1471,996,,tiestriker88,-2,5,5,50%,10,2023/04/13
1472,996,,Mr. Fahrenheit,+2,5,5,50%,10,2023/04/10
1473,996,,efjot_ep,+1,13,12,52%,25,2023/04/08
1474,996,,Foxxo,-2,16,17,48%,33,2023/04/13
1475,996,,DaReDeViL,-1,5,6,45%,11,2023/04/17
1476,996,,mickal21,-1,12,12,50%,24,2023/04/15
1477,996,,sebaschaos,-2,74,76,49%,150,2023/04/03
1478,995,,Karthago,-1,12,14,46%,26,2023/04/13
1479,995,,Angler Stein,+1,5,5,50%,10,2023/03/31
1480,995,,kdguno,-5,8,9,47%,17,2023/04/11
1481,995,,AndreMafia,-3,11,12,48%,23,2023/04/15
1482,995,,Cpt.Crunch,-2,10,10,50%,20,2023/04/09
1483,995,,Owieczka,-2,17,16,52%,33,2023/04/10
1484,995,,Autobahn Bisquick,-1,6,7,46%,13,2023/03/24
1485,995,,anthrod,+2,15,12,56%,27,2023/03/22
1486,995,,Lopal8787,+1,6,6,50%,12,2023/03/24
1487,994,,SteezyFebrezeMe,-1,6,8,43%,14,2023/04/12
1488,994,,小霸王其乐无穷,+2,5,6,45%,11,2023/04/15
1489,994,,Crash Override,+1,41,43,49%,84,2023/04/17
1490,994,,sssczlotq,-4,5,6,45%,11,2023/03/21
1491,994,,Ironman_2000,-3,10,10,50%,20,2023/03/27
1492,993,,Antagonist,-3,26,28,48%,54,2023/04/17
1493,993,,FA_Cpl,-3,11,14,44%,25,2023/04/16
1494,993,,BigTymer,+1,11,9,55%,20,2023/04/14
1495,993,,Bugle Dog,-4,34,30,53%,64,2023/04/14
1496,993,,ForFreedom,+2,6,5,55%,11,2023/04/17
1497,992,,Elessar,+1,6,8,43%,14,2023/04/12
1498,992,,Nate Dias,+3,58,54,52%,112,2023/04/16
1499,992,,TurboPepsi,-1,8,10,44%,18,2023/04/11
1500,992,,Lotto Max,-1,10,9,53%,19,2023/04/13
1501,991,,Foaly,+1,16,20,44%,36,2023/03/31
1502,991,,IgM-BcR,+1,9,13,41%,22,2023/04/16
1503,991,,BILBOBUSSINS,+3,14,14,50%,28,2023/04/09
1504,991,,carltonscott,-1,91,96,49%,187,2023/04/17
1505,991,,h403515707,+1,14,14,50%,28,2023/04/13
1506,991,,我干拉了，你呢？,-1,17,18,49%,35,2023/04/11
1507,990,,LosBastardo,-1,12,15,44%,27,2023/03/21
1508,990,,CosmeFulanito,+1,5,6,45%,11,2023/03/22
1509,990,,WaKKeL,+1,28,24,54%,52,2023/04/17
1510,990,,Pacman - Animarchy,-2,7,9,44%,16,2023/04/05
1511,990,,AutomaticAutocratic,-3,28,37,43%,65,2023/04/14
1512,989,,Razier,+3,51,50,50%,101,2023/04/11
1513,989,,Shinran,-3,22,21,51%,43,2023/04/04
1514,989,,Morbid Git,+1,11,10,52%,21,2023/04/15
1515,989,,Porky,-2,10,12,45%,22,2023/03/25
1516,989,,HIMMLER,-2,7,8,47%,15,2023/04/17
1517,989,,sormi,+3,17,21,45%,38,2023/04/06
1518,988,,Sorry,+1,5,5,50%,10,2023/04/17
1519,988,,BluemagicMichi,+1,83,76,52%,159,2023/04/17
1520,988,,Nognor,+2,11,10,52%,21,2023/04/11
1521,988,,I love Tiananmen,+2,13,11,54%,24,2023/04/15
1522,988,,ThanatosLT,+4,24,23,51%,47,2023/03/28
1523,988,,rlawodn40,-2,13,10,57%,23,2023/04/16
1524,987,,La Crevette,+1,6,6,50%,12,2023/04/02
1525,987,,Freshprince,+2,5,5,50%,10,2023/04/05
1526,987,,subzero_86,-2,17,22,44%,39,2023/04/04
1527,987,,Povke,+1,44,49,47%,93,2023/04/16
1528,987,,SpectacularRr,+2,4,7,36%,11,2023/04/16
1529,987,,Ser Arthur Dayne,+1,45,41,52%,86,2023/04/03
1530,986,,dog,-1,23,24,49%,47,2023/04/09
1531,986,,Rummel,-1,14,16,47%,30,2023/04/14
1532,986,,-EGON,-1,11,11,50%,22,2023/04/15
1533,986,,Y E N,+1,36,37,49%,73,2023/04/10
1534,986,,MadeManG74,-3,15,21,42%,36,2023/04/14
1535,986,,jehatchett,+2,8,8,50%,16,2023/04/16
1536,986,,Mad Cow,-4,7,9,44%,16,2023/03/30
1537,986,,Wüstenfuchs,-1,7,8,47%,15,2023/04/15
1538,986,,Divine Fury,+3,9,8,53%,17,2023/04/17
1539,985,,o3koastv,-2,23,23,50%,46,2023/04/14
1540,985,,tobias.1302,+2,10,11,48%,21,2023/04/17
1541,985,,{Eliote Le Pilote},+4,18,19,49%,37,2023/04/18
1542,985,,sic21ked,+3,6,6,50%,12,2023/04/12
1543,985,,Toasty,-1,5,5,50%,10,2023/04/01
1544,985,,Pepyetro,+2,26,17,60%,43,2023/04/17
1545,985,,Saint Michael,+5,16,13,55%,29,2023/04/17
1546,985,,Nightsighter,+3,7,7,50%,14,2023/04/03
1547,985,,NanokaFranca,-1,7,8,47%,15,2023/03/27
1548,984,,nAzY,-6,31,30,51%,61,2023/04/05
1549,984,,Madner,+1,22,28,44%,50,2023/04/17
1550,984,,CodyMody,-1,19,22,46%,41,2023/04/12
1551,984,,CodyMody,-1,19,22,46%,41,2023/04/12
1552,984,,DNguy,-3,6,6,50%,12,2023/04/07
1553,983,,jwilliams0747,+2,5,5,50%,10,2023/04/01
1554,983,,EvocatusMajin,-4,19,19,50%,38,2023/04/09
1555,983,,schorrock,+2,19,22,46%,41,2023/03/29
1556,983,,Kryptonos,+1,18,21,46%,39,2023/04/17
1557,983,,terrasigma,-1,9,9,50%,18,2023/04/06
1558,983,,DrymM8,-1,49,51,49%,100,2023/04/15
1559,982,,C. Troy,-1,30,26,54%,56,2023/04/08
1560,982,,[14e]tuveuxdugateaux,-1,6,7,46%,13,2023/03/25
1561,982,,Emyyn,-2,16,15,52%,31,2023/03/31
1562,982,,SovietUnionMOGU,+1,9,11,45%,20,2023/04/17
1563,982,,Warlot,+2,8,9,47%,17,2023/03/31
1564,982,,*D.Kabega*,+1,22,23,49%,45,2023/04/13
1565,982,,kiler47,-1,35,29,55%,64,2023/04/18
1566,982,,猫头鹰,+1,41,46,47%,87,2023/04/17
1567,981,,Bling Bling,-3,15,17,47%,32,2023/04/14
1568,981,,jollenhobler,-2,6,6,50%,12,2023/04/14
1569,981,,Quint,-1,5,5,50%,10,2023/04/08
1570,981,,Graska,+1,5,5,50%,10,2023/03/21
1571,981,,Strid,-2,17,17,50%,34,2023/03/27
1572,981,,MOses,-1,6,7,46%,13,2023/03/21
1573,981,,Shraken,-4,7,10,41%,17,2023/04/05
1574,981,,苟利国家....,-3,14,20,41%,34,2023/04/08
1575,980,,Dranu,-1,8,10,44%,18,2023/04/11
1576,980,,KrazyKoala,-5,5,7,42%,12,2023/03/21
1577,980,,Tato,+1,35,40,47%,75,2023/04/17
1578,980,,Astartes,-1,5,5,50%,10,2023/03/26
1579,980,,Kimin,+2,23,26,47%,49,2023/04/12
1580,980,,ljn818,+2,5,6,45%,11,2023/03/28
1581,979,,acn322,+2,11,9,55%,20,2023/04/09
1582,979,,iriskel,+1,13,12,52%,25,2023/04/16
1583,979,,Radu S.a.v.,+2,38,46,45%,84,2023/04/16
1584,979,,Vasutka,-1,5,6,45%,11,2023/03/30
1585,979,,William9796,+1,18,22,45%,40,2023/04/08
1586,978,,yitzak,-2,6,7,46%,13,2023/03/25
1587,978,,ISO-9000 Bauer,-4,8,12,40%,20,2023/04/03
1588,978,,Jaybee,+1,8,9,47%,17,2023/04/12
1589,978,,Hekezu,+1,10,10,50%,20,2023/04/03
1590,978,,Horriblus,-2,29,35,45%,64,2023/04/16
1591,978,,notorischer Ver(s)precher,-3,34,39,47%,73,2023/04/16
1592,977,,Rbizz,+1,22,16,58%,38,2023/04/08
1593,977,,thorvaldmjolnir,-1,10,10,50%,20,2023/04/16
1594,977,,Elvis the Rock Stinson,-4,6,8,43%,14,2023/03/25
1595,977,,Alrogan,+1,8,9,47%,17,2023/04/08
1596,977,,bigchunk1,+2,10,11,48%,21,2023/04/16
1597,977,,NZT-48-晓,+1,31,32,49%,63,2023/04/17
1598,977,,fabio4516,+2,17,22,44%,39,2023/04/09
1599,976,,Karim,+2,11,13,46%,24,2023/04/08
1600,976,,Glitch,+2,7,9,44%,16,2023/04/17
1601,976,,AP,-2,12,15,44%,27,2023/04/01
1602,976,,gambitfag,-1,5,5,50%,10,2023/04/15
1603,976,,sebeck,-1,50,52,49%,102,2023/04/17
1604,975,,Weisswolf,-3,17,21,45%,38,2023/03/30
1605,975,,Ninjagoat,-2,9,9,50%,18,2023/03/23
1606,975,,Sinverguenza,+1,9,11,45%,20,2023/04/10
1607,975,,Detritus,-1,44,49,47%,93,2023/04/03
1608,975,,The Miracle,+2,4,6,40%,10,2023/04/04
1609,974,,Scott,+2,6,6,50%,12,2023/04/10
1610,974,,Hagga,-1,5,6,45%,11,2023/03/31
1611,974,,WITTMANNS TIGER,-1,40,41,49%,81,2023/04/17
1612,974,,Tw_Yolin,+2,16,16,50%,32,2023/04/08
1613,974,,나이트오브,+2,9,11,45%,20,2023/04/12
1614,974,,二条院羽月,+1,12,11,52%,23,2023/04/17
1615,974,,WrathLord,-6,6,8,43%,14,2023/03/26
1616,974,,BarryWhite,-1,84,84,50%,168,2023/04/01
1617,974,,john31f,-2,7,8,47%,15,2023/04/12
1618,973,,Blackbird,-5,10,16,38%,26,2023/04/15
1619,973,,入台作战第一远征军,-1,28,30,48%,58,2023/04/17
1620,973,,RadialEngine,+3,15,13,54%,28,2023/04/16
1621,972,,DragonFaith,+2,5,5,50%,10,2023/04/06
1622,972,,Vasja,-1,6,6,50%,12,2023/04/14
1623,972,,Xenion501,+2,45,46,49%,91,2023/04/13
1624,972,,MichaelOyster,-4,8,10,44%,18,2023/04/14
1625,972,,Der Heidenkaiser,-4,8,11,42%,19,2023/03/28
1626,971,,Lemon and Apples,+1,16,16,50%,32,2023/04/13
1627,971,,Spiggle,-5,9,13,41%,22,2023/03/30
1628,971,,In-Ex,-1,6,6,50%,12,2023/03/31
1629,971,,matsy,-2,7,9,44%,16,2023/04/11
1630,971,,Samp,+1,13,17,43%,30,2023/04/10
1631,971,,LMFAO wHo cAREAS HAHA Xd,-4,7,9,44%,16,2023/04/02
1632,971,,Freaky,-3,8,8,50%,16,2023/04/13
1633,971,,Kapten,-5,11,15,42%,26,2023/03/26
1634,971,,ШПАНА,+1,29,31,48%,60,2023/04/15
1635,970,,LuWatiX,+1,7,7,50%,14,2023/04/13
1636,970,,sladjanbre,+1,33,38,46%,71,2023/04/08
1637,970,,ibraheem0Alpha,-1,21,24,47%,45,2023/04/10
1638,970,,hitman87150,-1,8,12,40%,20,2023/03/29
1639,970,,Tyberson88,-3,7,13,35%,20,2023/03/31
1640,970,,Eccle,+3,25,20,56%,45,2023/03/28
1641,970,,Thala / Chris,-1,6,6,50%,12,2023/03/24
1642,970,,khm107105,+2,16,22,42%,38,2023/04/17
1643,969,,horstkevin,-4,10,12,45%,22,2023/04/06
1644,969,,infamous101,-3,20,25,44%,45,2023/04/02
1645,969,,PAinCOMiNG,+1,18,14,56%,32,2023/04/09
1646,968,,BGJ,-2,10,12,45%,22,2023/04/16
1647,968,,witrilix,-2,15,18,45%,33,2023/04/03
1648,968,,schwufti Schwuft,-1,4,6,40%,10,2023/03/30
1649,968,,Wild-Muffin,-1,7,8,47%,15,2023/03/24
1650,968,,toto,+1,8,9,47%,17,2023/04/15
1651,968,,vipasyn,-1,13,12,52%,25,2023/03/23
1652,968,,OhSnap,+1,24,24,50%,48,2023/04/15
1653,968,,BarrackOBombya,-1,11,16,41%,27,2023/04/13
1654,968,,Waterbottle,-2,6,8,43%,14,2023/04/13
1655,968,,tq251,-4,12,16,43%,28,2023/04/02
1656,968,,Koenigbanane,-1,21,21,50%,42,2023/04/15
1657,968,,溺水的巨人,-1,45,49,48%,94,2023/04/13
1658,967,,Raio,+3,9,8,53%,17,2023/04/18
1659,967,,Boogaloo,+2,45,48,48%,93,2023/04/17
1660,967,,Doggy,-2,19,24,44%,43,2023/04/13
1661,967,,master maeng,+1,28,32,47%,60,2023/03/26
1662,967,,Dat_Cat,-1,43,41,51%,84,2023/04/06
1663,967,,GKa,-4,38,52,42%,90,2023/04/17
1664,966,,Sercodttv,-2,7,7,50%,14,2023/04/09
1665,966,,furious chicken,-7,4,7,36%,11,2023/03/30
1666,966,,Ced1,+3,87,95,48%,182,2023/04/16
1667,966,,oca selvatica,-2,7,11,39%,18,2023/04/15
1668,966,,861606598,+1,6,6,50%,12,2023/04/08
1669,965,,Boombastian,-3,8,10,44%,18,2023/04/01
1670,965,,Grand,-2,7,9,44%,16,2023/04/11
1671,965,,[2.FJg]Radroach -Schtz,-4,29,34,46%,63,2023/04/09
1672,965,,Mortar Punch,-3,10,10,50%,20,2023/04/05
1673,965,,fontinixxl,-1,29,29,50%,58,2023/04/16
1674,965,,evo088,+3,61,65,48%,126,2023/04/16
1675,965,,Risky Fox,-2,40,48,45%,88,2023/04/15
1676,965,,Dr.Draese,-3,8,11,42%,19,2023/04/03
1677,964,,[BFTB] Drachi ッ,+2,24,26,48%,50,2023/04/16
1678,964,,BroTal1ty,-1,6,7,46%,13,2023/03/31
1679,964,,Kotypa,+1,8,9,47%,17,2023/04/01
1680,964,,General Scales,-3,4,6,40%,10,2023/04/08
1681,964,,UnderParr,-1,94,93,50%,187,2023/04/17
1682,964,,Spartans Attack,-1,34,36,49%,70,2023/04/02
1683,963,,travis_tyrone,+1,54,53,50%,107,2023/03/28
1684,963,,Holy montain,+2,61,63,49%,124,2023/04/10
1685,963,,Jurek Kiler,+1,8,11,42%,19,2023/04/14
1686,963,,Midti,+1,14,13,52%,27,2023/04/12
1687,963,,[P-CAN] ttv/cccilytf2,-3,10,12,45%,22,2023/04/18
1688,963,,wong.wilfred,-4,11,13,46%,24,2023/04/15
1689,963,,~(˘▾˘~),+1,8,8,50%,16,2023/03/31
1690,962,,Mishkashmoodle,+1,31,35,47%,66,2023/04/17
1691,962,,McGriggles,-2,9,11,45%,20,2023/04/11
1692,962,,RN42,-1,18,21,46%,39,2023/04/17
1693,962,,Malvae',+1,18,25,42%,43,2023/04/16
1694,962,,Topone,+1,6,7,46%,13,2023/04/06
1695,962,,[ZG]Dak,+1,7,10,41%,17,2023/04/15
1696,961,,noprisonersnick,-1,24,25,49%,49,2023/04/01
1697,961,,乡下来得老鼠,-2,5,7,42%,12,2023/03/25
1698,960,,Reb0rN,+3,13,12,52%,25,2023/04/01
1699,960,,Douyu_杨聚达,-2,74,76,49%,150,2023/04/14
1700,960,,Dark Lord Cthulhu,+1,10,10,50%,20,2023/04/17
1701,960,,pruck,-2,5,6,45%,11,2023/03/28
1702,959,,CHB19 RoLLsTEiN,+2,11,14,44%,25,2023/03/22
1703,959,,metalzone88,-6,6,8,43%,14,2023/04/14
1704,959,,Ashlande,+1,12,14,46%,26,2023/04/11
1705,958,,BlacKobs,+2,36,41,47%,77,2023/04/03
1706,958,,Diccolo,-4,37,32,54%,69,2023/04/16
1707,958,,heneryv3,+1,8,9,47%,17,2023/04/02
1708,958,,ZePPeliN,+1,19,21,48%,40,2023/03/21
1709,957,,Ariel,-1,6,7,46%,13,2023/03/23
1710,957,,Mapalon,-3,8,11,42%,19,2023/04/17
1711,957,,Matoux,+2,9,15,38%,24,2023/03/31
1712,956,,DKCörd,+2,19,19,50%,38,2023/03/26
1713,956,,Krustytheclown,-2,8,11,42%,19,2023/04/14
1714,956,,cellardoor,-7,29,31,48%,60,2023/04/17
1715,955,,poppe,-3,25,26,49%,51,2023/04/03
1716,955,,vctorgab,+3,25,28,47%,53,2023/03/26
1717,955,,Endrom,-2,7,9,44%,16,2023/03/22
1718,955,,DomInic,-4,9,10,47%,19,2023/03/27
1719,955,,|..Boni..|,+2,5,6,45%,11,2023/03/27
1720,955,,broky,-6,28,28,50%,56,2023/04/14
1721,954,,ManFrau,+2,8,8,50%,16,2023/04/13
1722,954,,John Rambo 18,-2,11,12,48%,23,2023/03/31
1723,954,,Bigglupes,-2,35,31,53%,66,2023/04/01
1724,954,,Prof. Fart's Sniff Emporium,+1,8,9,47%,17,2023/04/09
1725,954,,Azrael,-1,37,40,48%,77,2023/04/07
1726,953,,Mungo,-1,5,6,45%,11,2023/04/09
1727,953,,Alwaroski,+1,6,9,40%,15,2023/04/01
1728,953,,Tornholio,+1,18,19,49%,37,2023/04/06
1729,953,,timo_phil,+1,25,31,45%,56,2023/04/12
1730,953,,Kylin,-2,8,12,40%,20,2023/04/09
1731,953,,Steiner85,-1,27,30,47%,57,2023/04/11
1732,953,,Yunicone==Jyurigon,+2,12,17,41%,29,2023/04/12
1733,952,,elbastardo77,-2,4,6,40%,10,2023/04/17
1734,952,,Uncle Cream,-1,6,8,43%,14,2023/04/16
1735,952,,Wensleydale our lord and saviour,-2,4,6,40%,10,2023/03/22
1736,952,,awokeN 1904.,-1,6,11,35%,17,2023/04/14
1737,952,,큐쟌,-2,17,18,49%,35,2023/04/17
1738,952,,fbKJ1995,+1,35,33,51%,68,2023/04/13
1739,951,,Spritzgebäck,-3,13,17,43%,30,2023/04/18
1740,951,,Cherokee,-1,20,19,51%,39,2023/04/07
1741,951,,wojak zoomer,+2,11,12,48%,23,2023/03/31
1742,951,,Smellex,+2,5,6,45%,11,2023/04/13
1743,951,,alberugi00,+1,15,11,58%,26,2023/04/04
1744,951,,TheMandoX2,-1,19,21,48%,40,2023/04/01
1745,950,,playfamilly,-1,9,10,47%,19,2023/04/05
1746,950,,CDCusa,-2,9,12,43%,21,2023/04/09
1747,950,,SpiritsZ,-1,49,49,50%,98,2023/04/17
1748,950,,razzie,-1,6,7,46%,13,2023/04/05
1749,950,,Orbitals,-5,17,21,45%,38,2023/03/28
1750,950,,Nicklas,+3,21,24,47%,45,2023/04/13
1751,949,,Draakul,-1,4,6,40%,10,2023/03/21
1752,949,,SunBro,+1,11,14,44%,25,2023/04/01
1753,949,,sestone,-6,4,7,36%,11,2023/04/01
1754,948,,KiNGHuNT,-1,11,15,42%,26,2023/04/08
1755,948,,amateur shut in,-1,9,11,45%,20,2023/03/22
1756,948,,Vizantum,+2,19,20,49%,39,2023/04/11
1757,948,,Magnus Furius,-1,4,7,36%,11,2023/04/02
1758,948,,tearbath,-3,27,31,47%,58,2023/04/06
1759,948,,Killer_bunny,-1,17,20,46%,37,2023/04/12
1760,948,,doctorpanzer,+1,5,6,45%,11,2023/03/31
1761,948,,DovDim,+3,24,30,44%,54,2023/04/17
1762,948,,SOLID,+2,6,8,43%,14,2023/03/26
1763,948,,Louis Gluton,+1,9,11,45%,20,2023/03/29
1764,947,,Azang0,-1,68,68,50%,136,2023/04/17
1765,947,,Krisdt,+2,9,10,47%,19,2023/04/09
1766,947,,ABCDEFG,-2,5,5,50%,10,2023/04/07
1767,947,,bigcomfypillow,+1,8,10,44%,18,2023/04/09
1768,946,,Clint Toastwood,-3,36,37,49%,73,2023/03/27
1769,946,,Lancer,+3,45,48,48%,93,2023/04/17
1770,946,,Pilsen,-2,8,10,44%,18,2023/03/28
1771,946,,Wrythe,-2,4,7,36%,11,2023/04/01
1772,946,,116276339,+3,38,42,48%,80,2023/04/01
1773,945,,No this is patrick,-2,13,17,43%,30,2023/04/13
1774,945,,Nubbl0r,+2,51,59,46%,110,2023/04/14
1775,945,,cod1933,-1,13,15,46%,28,2023/04/15
1776,945,,Ferreyd,-1,20,20,50%,40,2023/04/14
1777,945,,Reichsführer SS (CZ),-1,5,7,42%,12,2023/03/26
1778,945,,Escopeta,+3,5,6,45%,11,2023/04/01
1779,945,,BELL CRANEL,-1,41,44,48%,85,2023/04/11
1780,945,,AAA,-4,9,13,41%,22,2023/04/04
1781,944,,Bongking,-2,7,7,50%,14,2023/04/02
1782,944,,sniper pilot 20,-4,4,6,40%,10,2023/04/04
1783,944,,animalwang,+1,10,11,48%,21,2023/04/16
1784,944,,Wunderwaffe,+2,14,18,44%,32,2023/04/06
1785,944,,TopG,-1,16,19,46%,35,2023/04/10
1786,944,,Gargasmell,-1,6,8,43%,14,2023/04/08
1787,944,,Mikami,-1,7,8,47%,15,2023/04/17
1788,944,,matsieron,-1,20,20,50%,40,2023/04/12
1789,944,,PGLee,-3,7,12,37%,19,2023/04/16
1790,943,,Dick Kickem,-2,19,17,53%,36,2023/03/29
1791,943,,Killer100,+5,5,7,42%,12,2023/03/21
1792,943,,StoNie,-4,10,16,38%,26,2023/04/04
1793,943,,lucasniy,-4,4,7,36%,11,2023/04/12
1794,942,,Jenasaie,-1,5,6,45%,11,2023/04/09
1795,942,,Speed415,-1,10,12,45%,22,2023/04/13
1796,942,,Meex,+2,15,18,45%,33,2023/04/02
1797,942,,skyforce,-1,7,10,41%,17,2023/04/17
1798,942,,Teletubbi007,+3,26,33,44%,59,2023/03/24
1799,942,,JokerDart,+9,24,28,46%,52,2023/04/16
1800,941,,abiat1312,+1,13,14,48%,27,2023/04/01
1801,941,,Apollo,+1,6,8,43%,14,2023/04/04
1802,941,,Ookiemouth,-2,3,8,27%,11,2023/04/15
1803,941,,Imperator Thrax,-1,45,43,51%,88,2023/04/16
1804,941,,pasuco,+1,12,12,50%,24,2023/04/11
1805,941,,IIIIIIIIIIIIIIIII:-P,+2,19,23,45%,42,2023/04/02
1806,940,,hallolinski,-1,27,30,47%,57,2023/04/16
1807,940,,namakusyapa,-7,9,14,39%,23,2023/04/16
1808,940,,Delta_Tiger94,-6,4,7,36%,11,2023/03/28
1809,940,,a7695834,-1,13,15,46%,28,2023/04/12
1810,940,,Goblin,+2,6,8,43%,14,2023/04/14
1811,940,,luca magno,-2,5,6,45%,11,2023/04/03
1812,940,,AssInspection,-1,32,33,49%,65,2023/04/16
1813,939,,Mr-HyDe,-1,3,7,30%,10,2023/03/23
1814,939,,que,-1,23,27,46%,50,2023/04/14
1815,939,,Armstroan Bance,-1,4,7,36%,11,2023/04/05
1816,939,,chris,-1,7,10,41%,17,2023/03/25
1817,938,,Lawyer_TR,-3,22,23,49%,45,2023/04/04
1818,938,,Gary Oak,-1,15,23,39%,38,2023/04/03
1819,938,,Nazca,-2,11,13,46%,24,2023/04/12
1820,938,,God Emperor,-1,4,6,40%,10,2023/04/09
1821,937,,Sturmtanne 4272,-2,13,20,39%,33,2023/04/02
1822,937,,mool,-2,8,14,36%,22,2023/04/17
1823,937,,STAVKA,+3,15,16,48%,31,2023/03/21
1824,937,,tm,-4,9,12,43%,21,2023/04/14
1825,937,,Diamondback,-2,4,6,40%,10,2023/04/11
1826,936,,Nomkop,-1,20,20,50%,40,2023/04/01
1827,936,,Umbert,+2,36,42,46%,78,2023/03/29
1828,936,,Mako,+1,15,22,41%,37,2023/04/11
1829,936,,Seiro,-4,5,7,42%,12,2023/04/14
1830,936,,Junaid,+3,8,11,42%,19,2023/04/17
1831,936,,Anarchism,+1,26,26,50%,52,2023/04/09
1832,936,,BOB,-1,59,61,49%,120,2023/03/22
1833,935,,Icebox_Huhn007,-6,16,17,48%,33,2023/04/17
1834,935,,Krieghound,+1,9,11,45%,20,2023/04/16
1835,935,,Yabgu Nizam Pasha,-3,5,8,38%,13,2023/04/02
1836,935,,RTK|Abascantus,-1,6,8,43%,14,2023/03/26
1837,935,,喵了个咪,+1,7,9,44%,16,2023/04/16
1838,935,,poorgrammar,+3,4,6,40%,10,2023/04/16
1839,934,,1900,+1,11,16,41%,27,2023/04/15
1840,934,,Deepshine,-3,13,16,45%,29,2023/04/15
1841,934,,josh27armstrong,-1,17,17,50%,34,2023/03/23
1842,934,,homelesswithcigs,-4,25,32,44%,57,2023/04/17
1843,934,,the.dude,-2,10,14,42%,24,2023/04/02
1844,933,,鄙人張麻子,+2,9,10,47%,19,2023/04/11
1845,933,,HYSTERIAZ#,+1,11,16,41%,27,2023/04/09
1846,932,,Mighty Pirate,-1,7,10,41%,17,2023/03/27
1847,932,,be4rd3d_s4murai,-1,20,20,50%,40,2023/04/17
1848,932,,Crag,-1,7,10,41%,17,2023/04/17
1849,932,,Baddentist,+2,7,8,47%,15,2023/04/14
1850,932,,AC_Baldo,+3,17,17,50%,34,2023/04/15
1851,932,,deus vult,-1,6,9,40%,15,2023/04/16
1852,932,,Willy,-1,8,11,42%,19,2023/04/02
1853,932,,LEOPARD1492,+6,13,11,54%,24,2023/04/16
1854,931,,shz007,-3,12,16,43%,28,2023/04/10
1855,931,,Rukoso,+3,7,10,41%,17,2023/04/16
1856,931,,[FAT32] DUFF MAN(GER),-1,8,13,38%,21,2023/04/15
1857,931,,varunanand15,-1,6,11,35%,17,2023/03/21
1858,930,,sniffin ur toes,+1,9,11,45%,20,2023/04/09
1859,930,,Coldair,+5,26,26,50%,52,2023/04/07
1860,930,,Camperino,+1,4,6,40%,10,2023/04/10
1861,930,,Mr.Kuk,-4,17,24,41%,41,2023/04/17
1862,930,,Dbotiii1111,-1,5,6,45%,11,2023/03/23
1863,930,,General Joe,-1,6,9,40%,15,2023/04/06
1864,930,,justy11111,-1,73,82,47%,155,2023/04/17
1865,930,,Werner von Nazareth,+2,5,6,45%,11,2023/04/04
1866,930,,Bakayre,-2,19,21,48%,40,2023/04/01
1867,929,,SHIHAHA,+1,8,10,44%,18,2023/04/16
1868,929,,YYY_近战法师刘海柱,-3,28,24,54%,52,2023/04/14
1869,929,,Nealsen,+3,9,10,47%,19,2023/04/02
1870,929,,KrulAsfaltuf,-1,8,12,40%,20,2023/04/06
1871,929,,dutchdisaster,-3,11,16,41%,27,2023/04/11
1872,929,,Twilight,-4,4,6,40%,10,2023/04/09
1873,929,,simsalabim,-4,12,18,40%,30,2023/04/01
1874,929,,2015044103,+3,20,28,42%,48,2023/04/16
1875,929,,KleinMeser,+3,11,12,48%,23,2023/04/17
1876,929,,luckyes63,-4,16,21,43%,37,2023/04/16
1877,929,,threepwood,-1,5,7,42%,12,2023/03/28
1878,928,,Maik,-1,4,7,36%,11,2023/03/28
1879,928,,AlexanderTGreat,+2,54,61,47%,115,2023/04/17
1880,928,,PartTime_RebeL,-2,7,9,44%,16,2023/04/16
1881,928,,Idle Hands,+1,8,11,42%,19,2023/04/14
1882,928,,azur,+2,25,27,48%,52,2023/04/18
1883,927,,Papercut_GR,-2,45,49,48%,94,2023/04/08
1884,927,,pannery,-3,8,11,42%,19,2023/03/24
1885,927,,'Keeperandersen^¨,+1,4,7,36%,11,2023/04/17
1886,926,,DaddyCool,+2,36,41,47%,77,2023/04/17
1887,926,,Finion,-3,12,15,44%,27,2023/04/13
1888,926,,_ABC_,-1,4,6,40%,10,2023/04/14
1889,926,,Singularity,+1,12,15,44%,27,2023/03/27
1890,926,,daviaud_rod,-1,4,7,36%,11,2023/04/15
1891,926,,德瑞克,+1,26,23,53%,49,2023/04/15
1892,925,,davey,-1,8,10,44%,18,2023/03/26
1893,925,,derherr,-1,5,7,42%,12,2023/03/29
1894,925,,Desaya,+1,4,6,40%,10,2023/04/14
1895,925,,alphazaheer,+1,14,18,44%,32,2023/04/16
1896,925,,PhantomErection,-1,13,12,52%,25,2023/04/17
1897,924,,tfoteinop,+1,6,8,43%,14,2023/04/01
1898,924,,2501885777,+6,29,31,48%,60,2023/04/11
1899,924,,JayT,+1,9,12,43%,21,2023/03/27
1900,924,,Theonelegion,-2,6,9,40%,15,2023/03/26
1901,924,,Dauskun,-1,4,9,31%,13,2023/04/15
1902,924,,Tr1t0s,-6,5,10,33%,15,2023/03/30
1903,924,,Ayreon333,-1,36,40,47%,76,2023/04/17
1904,923,,luchstefano,+1,5,6,45%,11,2023/04/16
1905,923,,Saitenspiel,-1,66,73,47%,139,2023/04/16
1906,923,,Nahuipohui,-3,158,161,50%,319,2023/04/17
1907,923,,AlCapwnage,-2,5,7,42%,12,2023/03/27
1908,922,,SKeLa,-3,13,17,43%,30,2023/04/09
1909,922,,Dragopolus,-5,12,16,43%,28,2023/03/24
1910,922,,MenteMaestra,+3,108,114,49%,222,2023/04/16
1911,922,,Manous,+1,13,17,43%,30,2023/03/26
1912,922,,Schlageter,-2,8,13,38%,21,2023/04/16
1913,922,,欧神仙,-4,6,9,40%,15,2023/04/11
1914,922,,JimmyBoy,-1,6,9,40%,15,2023/04/09
1915,922,,ThoMaz,-4,52,58,47%,110,2023/04/14
1916,922,,Operator,+2,11,14,44%,25,2023/04/07
1917,922,,Enriquexs(CHI),-3,14,19,42%,33,2023/03/31
1918,921,,Greeno6,+2,4,7,36%,11,2023/04/13
1919,920,,luwenyu110,-1,5,8,38%,13,2023/03/21
1920,920,,大英帝国第六步兵师,-5,17,23,43%,40,2023/04/04
1921,920,,OdinsChosen,-3,14,19,42%,33,2023/04/01
1922,920,,Sebbest1,+1,21,31,40%,52,2023/04/10
1923,920,,DeusVulpe,-1,9,10,47%,19,2023/04/07
1924,920,,Sauce PiKKante,+1,18,22,45%,40,2023/04/12
1925,920,,masterhex,+2,44,50,47%,94,2023/04/17
1926,920,,hentai is my passion,+1,4,7,36%,11,2023/04/10
1927,920,,Grafff,+2,9,9,50%,18,2023/04/16
1928,920,,LikioOo,+3,12,14,46%,26,2023/04/16
1929,920,,Huzardadi,+4,18,19,49%,37,2023/04/18
1930,920,,Hostis,-3,8,12,40%,20,2023/04/08
1931,919,,hoiKINpig,-1,22,21,51%,43,2023/04/12
1932,919,,wildes pony,+3,40,51,44%,91,2023/04/12
1933,919,,bb70,+4,25,26,49%,51,2023/04/16
1934,919,,Lucke,-1,16,17,48%,33,2023/03/22
1935,919,,Julek,+2,14,17,45%,31,2023/03/29
1936,918,,GourghK,-1,6,7,46%,13,2023/04/16
1937,918,,Kobralo,-1,4,6,40%,10,2023/04/11
1938,918,,Elroy lee,-1,45,41,52%,86,2023/04/08
1939,918,,FullForc3,-1,5,8,38%,13,2023/03/29
1940,918,,BlitzMachine,+1,6,8,43%,14,2023/03/25
1941,917,,N-xpat89,-1,8,12,40%,20,2023/03/22
1942,917,,Galooph,+2,7,8,47%,15,2023/03/22
1943,917,,Dr.Gonzo,-3,6,9,40%,15,2023/03/31
1944,917,,Psyclone,+1,30,34,47%,64,2023/04/14
1945,917,,GoldenBoy,-2,4,6,40%,10,2023/04/04
1946,916,,Baessler,+1,13,15,46%,28,2023/03/29
1947,916,,Armless Guy Gaming,-1,13,13,50%,26,2023/04/14
1948,916,,marshalrommelfox,+1,38,45,46%,83,2023/04/16
1949,916,,Mufasa,+4,9,11,45%,20,2023/04/06
1950,915,,Morkha ||,-2,5,9,36%,14,2023/04/17
1951,915,,Steven,+2,7,9,44%,16,2023/04/08
1952,914,,black,+1,7,11,39%,18,2023/04/04
1953,914,,Bineto,-1,17,18,49%,35,2023/04/10
1954,914,,General Ho Lee phuc,+1,20,26,43%,46,2023/04/16
1955,914,,JimboJimi,+3,15,21,42%,36,2023/03/31
1956,914,,kiwisteel_95,+1,12,14,46%,26,2023/04/12
1957,913,,Lars Cloos aka Big Tasty Junge,-3,6,8,43%,14,2023/03/26
1958,913,,jycop,-1,5,10,33%,15,2023/04/09
1959,912,,CptPanic,-2,13,13,50%,26,2023/04/05
1960,912,,RC,-4,5,8,38%,13,2023/04/16
1961,912,,Hobofingers,+5,5,7,42%,12,2023/04/03
1962,912,,Protek,-4,4,7,36%,11,2023/03/26
1963,912,,Raven,+2,10,10,50%,20,2023/04/16
1964,912,,MajorMB,+1,14,18,44%,32,2023/03/31
1965,911,,Godless,+2,9,11,45%,20,2023/04/02
1966,911,,van_Sipla,-4,3,7,30%,10,2023/04/03
1967,911,,Cahir de Seren,+3,4,7,36%,11,2023/04/14
1968,911,,zelensky65,+3,14,16,47%,30,2023/04/10
1969,910,,DuskTheViking,+1,68,76,47%,144,2023/03/24
1970,909,,Tryptamine,-1,21,27,44%,48,2023/03/21
1971,909,,Sgt.DasheRRR,-3,43,47,48%,90,2023/04/15
1972,909,,Riddick,+2,10,13,43%,23,2023/04/16
1973,909,,GamblingNik,-3,5,8,38%,13,2023/04/05
1974,909,,COMRADE PUTIN,-5,7,11,39%,18,2023/03/30
1975,909,,danrylee,+1,10,14,42%,24,2023/04/10
1976,908,,Spikey115,+1,72,82,47%,154,2023/04/16
1977,907,,wotsefak?,-3,11,13,46%,24,2023/03/31
1978,907,,YourOnTheBarbie,+1,93,96,49%,189,2023/03/31
1979,907,,Hans von Glocken,-1,24,30,44%,54,2023/04/11
1980,907,,Mick,-2,6,9,40%,15,2023/04/11
1981,907,,Thibonx,-1,24,26,48%,50,2023/04/13
1982,907,,FIRSTCLASS,+2,4,6,40%,10,2023/04/12
1983,907,,Poop Juice,-2,5,8,38%,13,2023/03/23
1984,907,,Night,-5,9,12,43%,21,2023/03/30
1985,906,,PURE_FROG,-1,66,74,47%,140,2023/04/16
1986,906,,Fist of Steel,-1,9,11,45%,20,2023/04/15
1987,906,,GröFaZ,-3,12,17,41%,29,2023/04/14
1988,906,,Roxbery,+1,12,12,50%,24,2023/04/15
1989,906,,Koneg,-5,6,10,38%,16,2023/03/24
1990,906,,Steven Seagal,+1,9,14,39%,23,2023/04/17
1991,906,,mosq1234w,-1,12,15,44%,27,2023/04/05
1992,906,,childplease,+2,12,14,46%,26,2023/04/08
1993,905,,Pustynny junak,+2,13,16,45%,29,2023/04/05
1994,905,,TUSKA DA DEMON KILLA,+1,6,7,46%,13,2023/04/12
1995,905,,Théophile de Lerne,-1,18,25,42%,43,2023/04/08
1996,905,,feifeiufo,-6,4,9,31%,13,2023/04/13
1997,905,,☼ Astinus ☼,+1,13,18,42%,31,2023/04/16
1998,905,,D3LT4,+5,9,11,45%,20,2023/04/17
1999,904,,jamister911,-2,7,11,39%,18,2023/04/15
2000,904,,Moe.M,-2,6,10,38%,16,2023/04/12
2001,904,,STONEgolem,+1,21,25,46%,46,2023/04/17
2002,904,,Shikabane,+1,8,11,42%,19,2023/04/17
2003,904,,Lieutenant Guy,-2,5,9,36%,14,2023/03/27
2004,904,,국민척탄병,-1,6,8,43%,14,2023/04/01
2005,903,,Duendex,-3,8,10,44%,18,2023/04/04
2006,903,,Dubzie,+2,10,10,50%,20,2023/04/06
2007,903,,vilsaulius,+1,26,36,42%,62,2023/04/17
2008,903,,Nobody,+1,7,8,47%,15,2023/04/13
2009,903,,GTA 40K | Keykeeper,-1,7,12,37%,19,2023/03/28
2010,903,,Swedish Moose,-4,5,10,33%,15,2023/03/25
2011,903,,__++__==,+1,102,116,47%,218,2023/04/17
2012,902,,Rakke1848,-1,15,18,45%,33,2023/04/16
2013,901,,DRDOOM_NZ,+1,28,31,47%,59,2023/04/14
2014,901,,DardL,-1,4,7,36%,11,2023/04/13
2015,901,,plati2d2 (Esp),-1,4,6,40%,10,2023/04/13
2016,901,,Maximus_#3403,-1,9,10,47%,19,2023/04/09
2017,901,,nathan_ohanlon,-2,5,8,38%,13,2023/03/26
2018,901,,tomastys,+4,15,20,43%,35,2023/04/13
2019,901,,霍子,-3,8,15,35%,23,2023/04/10
2020,901,,SasquatchFelix,-5,6,9,40%,15,2023/04/16
2021,900,,Karl Birdsong,+1,8,11,42%,19,2023/04/09
2022,900,,Andy77,-1,24,25,49%,49,2023/04/06
2023,900,,Vampir,-1,8,9,47%,17,2023/04/03
2024,900,,Mc.Lame,-4,4,11,27%,15,2023/04/15
2025,900,,NotoriousLAB,+1,3,7,30%,10,2023/04/18
2026,900,,Socrates,-7,3,8,27%,11,2023/04/13
2027,900,,Wazup_de,+2,3,7,30%,10,2023/03/26
2028,900,,St. Bucko Slays the Dragon,-1,43,52,45%,95,2023/04/12
2029,900,,Markner,+1,23,25,48%,48,2023/04/15
2030,900,,496E76616C6964537472696E67,-5,3,9,25%,12,2023/03/26
2031,899,,Latrinenzombie,-1,4,8,33%,12,2023/04/06
2032,898,,Ghost,+1,13,14,48%,27,2023/04/18
2033,898,,LickLuck,+2,5,9,36%,14,2023/04/16
2034,898,,Autumn of Winter,-2,21,20,51%,41,2023/04/17
2035,897,,Harold Hoffmann,-1,9,13,41%,22,2023/04/01
2036,897,,Petrov,+1,14,17,45%,31,2023/04/07
2037,897,,Von Seltei,+2,39,41,49%,80,2023/04/04
2038,897,,Ryūk7,-3,7,9,44%,16,2023/03/21
2039,896,,Groooooo,-2,45,49,48%,94,2023/04/11
2040,896,,JohnstyPonst,-6,3,7,30%,10,2023/03/30
2041,896,,Nefretus,+1,21,23,48%,44,2023/04/15
2042,896,,Munin,-6,5,10,33%,15,2023/04/01
2043,896,,ビクトリーハウス柴田,+1,9,14,39%,23,2023/04/07
2044,895,,Khorne's Penguin,-1,5,6,45%,11,2023/03/28
2045,895,,SORN E.,-1,26,31,46%,57,2023/04/16
2046,895,,he565,+3,19,23,45%,42,2023/04/16
2047,895,,0ni,-2,4,7,36%,11,2023/03/27
2048,895,,DJ Misha,-2,30,34,47%,64,2023/04/17
2049,894,,CZECH /1st. Division,+1,7,10,41%,17,2023/03/26
2050,894,,Byakuyabo,+2,6,8,43%,14,2023/04/02
2051,894,,Painkiller,-1,39,46,46%,85,2023/04/17
2052,894,,006Horst_der_echte,+1,18,18,50%,36,2023/04/09
2053,894,,Shintao,-4,23,28,45%,51,2023/04/15
2054,894,,ritty,-5,8,15,35%,23,2023/04/17
2055,894,,Fabian,+1,7,10,41%,17,2023/04/16
2056,893,,ETALYCS,-3,5,8,38%,13,2023/03/28
2057,893,,stg44,-2,40,46,47%,86,2023/03/29
2058,893,,Kanonenvogel,+1,13,17,43%,30,2023/04/17
2059,893,,Buddhabear,-2,5,10,33%,15,2023/04/16
2060,892,,niki,-1,4,9,31%,13,2023/04/15
2061,892,,"|Oliver, der Friedliche",-2,11,15,42%,26,2023/03/30
2062,892,,舒潔衛生紙,-3,11,15,42%,26,2023/04/04
2063,892,,krokenreal,+1,6,11,35%,17,2023/04/15
2064,892,,ComradeCosmos,+1,6,8,43%,14,2023/04/10
2065,892,,huchen0103,-3,25,33,43%,58,2023/03/24
2066,891,,Sheepdogsheep,-4,6,9,40%,15,2023/04/01
2067,891,,Auld Smokey,+2,10,13,43%,23,2023/04/09
2068,891,,BRUTAL † HORDE,-3,81,86,49%,167,2023/04/15
2069,890,,Ostinato,-3,9,15,38%,24,2023/04/15
2070,890,,Indiana Jones,-1,33,36,48%,69,2023/04/17
2071,890,,Hans_Hackfresse,-3,5,7,42%,12,2023/04/06
2072,890,,Relaxaurus,-2,10,14,42%,24,2023/04/17
2073,890,,担架队,+1,11,18,38%,29,2023/04/11
2074,890,,rasta_poux,+2,4,7,36%,11,2023/04/16
2075,889,,tewnclub,+1,10,12,45%,22,2023/04/10
2076,889,,socif,-1,8,11,42%,19,2023/03/21
2077,889,,Len47,-4,18,19,49%,37,2023/04/16
2078,887,,OIDA,-5,4,7,36%,11,2023/03/22
2079,887,,Logarr,-4,6,12,33%,18,2023/03/29
2080,887,,=GULLS=Manthestars,+1,15,22,41%,37,2023/04/17
2081,887,,ARMAGEDDON_BETWEENER,-1,49,52,49%,101,2023/04/17
2082,886,,EDDIEtheEAGLE,+3,22,22,50%,44,2023/04/17
2083,886,,Al33Bundy,-1,21,27,44%,48,2023/04/08
2084,886,,tom Bradley,-2,4,7,36%,11,2023/03/25
2085,885,,nuns323,-1,3,8,27%,11,2023/04/16
2086,885,,MagicPants,-3,7,11,39%,18,2023/04/12
2087,885,,Samir22,-2,8,10,44%,18,2023/03/22
2088,885,,Tlords,+2,92,108,46%,200,2023/04/16
2089,885,,川哥指哪我打哪,-2,14,16,47%,30,2023/03/23
2090,885,,Ashoka,-1,43,51,46%,94,2023/04/16
2091,884,,Humasetu,+3,19,19,50%,38,2023/04/16
2092,884,,alex_XX29,-5,4,9,31%,13,2023/04/12
2093,884,,Cesare,-4,4,8,33%,12,2023/04/03
2094,884,,InZane iJay,+1,15,17,47%,32,2023/04/12
2095,884,,BestyBallz,-1,24,26,48%,50,2023/04/12
2096,883,,ManNoName,-5,9,15,38%,24,2023/04/16
2097,883,,edlvf3b2003,-1,8,16,33%,24,2023/04/08
2098,883,,AbLege,-1,6,9,40%,15,2023/04/06
2099,882,,Crixuz,-3,31,42,42%,73,2023/04/03
2100,882,,Deerisland,+1,48,45,52%,93,2023/04/17
2101,882,,StudioKreskiTattoo,-3,4,9,31%,13,2023/04/14
2102,882,,KidSoloDolo,-1,8,11,42%,19,2023/04/17
2103,881,,Elendil of Aldaron,-1,4,7,36%,11,2023/03/26
2104,881,,captain.pothead,-3,5,10,33%,15,2023/03/31
2105,881,,Pat,-1,10,14,42%,24,2023/03/29
2106,881,,OneX,-1,8,12,40%,20,2023/03/30
2107,881,,Schach,-2,6,11,35%,17,2023/03/31
2108,881,,Bloodraven,-4,24,29,45%,53,2023/04/15
2109,881,,memetz,-1,99,126,44%,225,2023/04/15
2110,881,,UH|ck,-4,44,52,46%,96,2023/04/17
2111,880,,connor18,-3,22,24,48%,46,2023/04/04
2112,880,,MAXICARTMAN,+1,15,22,41%,37,2023/04/01
2113,880,,Hrungner,-2,6,10,38%,16,2023/04/16
2114,880,,littleboots10,-1,15,22,41%,37,2023/04/16
2115,880,,Json,+3,11,18,38%,29,2023/03/30
2116,880,,Khârn,-2,5,9,36%,14,2023/04/05
2117,879,,<*JohnSky*>,-1,7,10,41%,17,2023/03/29
2118,879,,SureShot25x,-3,7,13,35%,20,2023/04/10
2119,879,,MatZpt,-6,8,16,33%,24,2023/04/02
2120,878,,Bint,-1,9,14,39%,23,2023/04/15
2121,878,,cruelaflood,+2,8,12,40%,20,2023/04/16
2122,878,,Lord Hon,-1,3,8,27%,11,2023/03/21
2123,878,,diegofvo,+1,16,21,43%,37,2023/04/12
2124,877,,StarTool,-5,9,15,38%,24,2023/04/10
2125,877,,MaDDo (:,+3,6,8,43%,14,2023/04/01
2126,876,,成吉思汗,+1,25,31,45%,56,2023/04/02
2127,876,,Behemonth,+1,4,8,33%,12,2023/04/12
2128,876,,CaptainProlo,-2,9,16,36%,25,2023/04/17
2129,876,,Red Bull Racing - Muscles,-2,63,73,46%,136,2023/04/17
2130,876,,Maciuś i Tatuś,-1,10,18,36%,28,2023/04/15
2131,876,,StuddlymuffinAK,+1,10,15,40%,25,2023/03/24
2132,876,,JackyChen,+1,82,97,46%,179,2023/04/17
2133,875,,Marmalade,-4,25,30,45%,55,2023/04/16
2134,875,,mythz0ne!,-2,4,7,36%,11,2023/04/16
2135,875,,m0gL1,-6,11,19,37%,30,2023/04/01
2136,874,,Niloc,-6,7,15,32%,22,2023/04/11
2137,873,,JuicyJuice0,-2,12,21,36%,33,2023/04/12
2138,873,,MSGT_Killjoy,-6,3,8,27%,11,2023/04/06
2139,873,,Le Baked,+1,28,36,44%,64,2023/04/07
2140,872,,Rayduhz,+1,28,35,44%,63,2023/04/11
2141,872,,g.nelson,+2,10,12,45%,22,2023/04/16
2142,871,,Unkind,+2,53,63,46%,116,2023/04/16
2143,871,,abs0843,-4,3,7,30%,10,2023/04/16
2144,870,,Jako,+1,11,21,34%,32,2023/04/01
2145,870,,Jinxx,-1,32,38,46%,70,2023/04/06
2146,870,,kusi86,+1,10,17,37%,27,2023/04/11
2147,870,,Major R. Sole,-3,7,14,33%,21,2023/04/07
2148,870,,Xi Jinping sympathiser,-4,32,36,47%,68,2023/03/25
2149,869,,Rü Guerrero,+2,3,7,30%,10,2023/04/02
2150,869,,Winston34,-2,7,11,39%,18,2023/03/31
2151,869,,Grambo,-3,4,7,36%,11,2023/03/29
2152,868,,Ranulfus,-1,4,8,33%,12,2023/04/14
2153,868,,pbricks.com,-2,31,49,39%,80,2023/04/17
2154,868,,b1ackie360,-1,20,28,42%,48,2023/04/17
2155,867,,DontKillMe,+1,11,16,41%,27,2023/04/15
2156,867,,DonStatus87,+5,18,23,44%,41,2023/04/17
2157,867,,RedTortilla,-1,6,11,35%,17,2023/04/06
2158,867,,officerkun,+2,11,13,46%,24,2023/04/05
2159,867,,Pille,+1,15,23,39%,38,2023/04/13
2160,866,,SwxG,-2,5,8,38%,13,2023/04/01
2161,866,,Caillou,+1,4,8,33%,12,2023/03/27
2162,866,,Kelja,+4,58,73,44%,131,2023/04/12
2163,866,,Plumb Dawg,+2,29,30,49%,59,2023/04/10
2164,866,,Dieu Débilus,-4,10,17,37%,27,2023/04/17
2165,865,,knobed,-1,6,11,35%,17,2023/04/11
2166,865,,alejose303,-3,8,14,36%,22,2023/04/07
2167,865,,Death-Bringer,+1,8,13,38%,21,2023/04/16
2168,865,,KING,+18,19,16,54%,35,2023/04/15
2169,865,,Jordy,+2,32,40,44%,72,2023/04/17
2170,864,,WalterWhite,+1,38,48,44%,86,2023/04/16
2171,864,,ran_to_the_ftl,-5,10,15,40%,25,2023/04/11
2172,864,,Tactical Tuna,+1,4,7,36%,11,2023/04/15
2173,864,,jambomir,-5,16,22,42%,38,2023/04/15
2174,864,,CorruptCornflake,-1,31,34,48%,65,2023/04/06
2175,864,,纯爱战神，渣女快爬,-2,11,21,34%,32,2023/04/17
2176,863,,freeman248xz,-1,4,7,36%,11,2023/03/31
2177,863,,"KHERSON, UKRAINE",+1,8,12,40%,20,2023/04/16
2178,863,,McCurtis,+1,15,23,39%,38,2023/03/31
2179,862,,Wildcard,+1,8,16,33%,24,2023/03/23
2180,862,,Napoleon Bonerfart,+1,21,21,50%,42,2023/04/02
2181,862,,Max_Ritter,+2,13,17,43%,30,2023/04/05
2182,862,,Chimuba,-7,4,10,29%,14,2023/04/16
2183,862,,terry,-1,9,13,41%,22,2023/04/14
2184,862,,mthrowaway,-1,5,9,36%,14,2023/04/08
2185,862,,Gaunt,-3,16,24,40%,40,2023/03/30
2186,861,,-SIBERIANWOLF-,+2,39,52,43%,91,2023/04/15
2187,861,,max.anderla,+5,18,21,46%,39,2023/04/16
2188,861,,caseycampbel,-3,7,12,37%,19,2023/04/16
2189,861,,Wickeda,+1,11,14,44%,25,2023/04/08
2190,861,,Madskill^^,+2,14,16,47%,30,2023/03/24
2191,860,,Franksalot,-1,12,16,43%,28,2023/04/07
2192,860,,Uncle Grandpa,+1,4,9,31%,13,2023/04/12
2193,860,,SlavikJunge,-4,4,9,31%,13,2023/04/03
2194,860,,Büffel,+1,18,25,42%,43,2023/04/17
2195,859,,Faebbi,-1,29,44,40%,73,2023/04/12
2196,859,,7c6e8186,-4,7,12,37%,19,2023/03/30
2197,859,,Ragga,-3,4,8,33%,12,2023/03/28
2198,858,,martin naseri,-2,4,7,36%,11,2023/04/11
2199,858,,Thoralf,+1,3,7,30%,10,2023/03/29
2200,858,,jarlzandvoort123,-1,6,8,43%,14,2023/04/03
2201,858,,bjornagain1963,-1,27,36,43%,63,2023/04/16
2202,858,,Lovestick,-1,84,91,48%,175,2023/04/17
2203,858,,bOipuSsi AiNt gAE,-2,18,30,38%,48,2023/04/06
2204,857,,Joni,+1,9,12,43%,21,2023/04/08
2205,857,,Claymorefun,-2,6,13,32%,19,2023/04/16
2206,856,,sword_sweeper,-3,12,16,43%,28,2023/04/18
2207,856,,Phenom,-7,4,9,31%,13,2023/03/27
2208,856,,marcelo26,-2,102,119,46%,221,2023/04/06
2209,856,,Tritolo,+1,5,8,38%,13,2023/04/09
2210,856,,Durandal,-5,9,15,38%,24,2023/04/12
2211,855,,Cthulhu,-4,6,11,35%,17,2023/03/27
2212,854,,ModernAce,-4,47,51,48%,98,2023/04/12
2213,854,,TimeVampire,-4,4,7,36%,11,2023/03/25
2214,854,,dam8909,-2,13,16,45%,29,2023/04/07
2215,854,,booyakaa,-2,12,14,46%,26,2023/04/08
2216,854,,应急食品派蒙,-3,48,69,41%,117,2023/04/15
2217,853,,Sinny,-2,3,8,27%,11,2023/03/21
2218,853,,AETIUS,-5,3,8,27%,11,2023/03/30
2219,853,,ᴥ bash ᴥ,-3,5,10,33%,15,2023/04/13
2220,853,,thankyou,-3,25,30,45%,55,2023/04/17
2221,852,,Gluengi,-6,4,10,29%,14,2023/04/16
2222,852,,KITSU.CL,-1,5,12,29%,17,2023/04/17
2223,852,,PrinceGoro,+1,8,12,40%,20,2023/04/17
2224,852,,ENEMY AT GATE,-2,5,11,31%,16,2023/04/05
2225,851,,XCumReborn,-3,6,13,32%,19,2023/04/01
2226,851,,Rucki,+2,9,14,39%,23,2023/03/22
2227,851,,Chucken McNiggets,-5,5,11,31%,16,2023/04/16
2228,851,,ailvjinyang,-3,26,29,47%,55,2023/04/09
2229,850,,eaglecall,+2,11,17,39%,28,2023/04/16
2230,850,,Dire Wolf,-4,6,12,33%,18,2023/04/17
2231,850,,Minimal MilloZ,-5,11,20,35%,31,2023/03/24
2232,849,,Griff0n,-1,15,21,42%,36,2023/04/14
2233,849,,Saiko,+2,19,27,41%,46,2023/04/17
2234,849,,Ronny,-4,6,15,29%,21,2023/04/17
2235,849,,Aron_2152,+5,13,15,46%,28,2023/03/25
2236,849,,SS Punk,-2,4,8,33%,12,2023/03/26
2237,848,,Cadrach,-5,6,14,30%,20,2023/04/16
2238,848,,blindstep,-5,22,32,41%,54,2023/04/16
2239,848,,PlushBean,-2,4,8,33%,12,2023/03/30
2240,848,,ᛉTodfeindᛣ,-3,10,17,37%,27,2023/03/23
2241,848,,MoNtEcRiStO,+2,18,27,40%,45,2023/04/17
2242,847,,golden Eagle,+1,7,11,39%,18,2023/04/05
2243,847,,an100der,+1,14,19,42%,33,2023/04/14
2244,847,,TeufelHund,+3,13,20,39%,33,2023/04/16
2245,847,,Nasigasi,+1,6,10,38%,16,2023/03/25
2246,847,,Leroy Putty,+1,6,10,38%,16,2023/04/02
2247,847,,DarthYukat,+1,20,27,43%,47,2023/04/01
2248,846,,FiziksXT,+1,11,17,39%,28,2023/04/17
2249,846,,Mudrock,-3,20,30,40%,50,2023/03/25
2250,846,,疯狂梅西,-5,32,42,43%,74,2023/04/03
2251,845,,Fu_kingLui,-8,7,15,32%,22,2023/03/22
2252,844,,to be (Y) or not to be (Y),-3,13,18,42%,31,2023/04/17
2253,844,,Juniorpred,+2,4,8,33%,12,2023/04/16
2254,844,,kamolapob01,-5,6,11,35%,17,2023/04/02
2255,844,,FleXxX89,+1,4,6,40%,10,2023/04/01
2256,843,,wstreb,-8,27,35,44%,62,2023/04/02
2257,843,,Tomsky147 John 3 vs 16,-1,3,7,30%,10,2023/03/25
2258,843,,Paralyzer,-4,48,53,48%,101,2023/03/29
2259,842,,dehuang,-4,7,13,35%,20,2023/04/04
2260,840,,Ramkang-x,-1,7,12,37%,19,2023/04/16
2261,840,,XNDY,-3,4,8,33%,12,2023/04/08
2262,839,,nickevans973,+3,18,22,45%,40,2023/04/07
2263,839,,CYBORGOR,+3,13,20,39%,33,2023/04/17
2264,839,,Taugenichts,-7,3,8,27%,11,2023/03/29
2265,839,,SerMack,-2,9,13,41%,22,2023/04/14
2266,839,,Bloody_Neighbour,+1,6,12,33%,18,2023/03/29
2267,839,,arfooonzo,-2,5,12,29%,17,2023/04/16
2268,839,,Camulas,-2,45,60,43%,105,2023/04/12
2269,838,,^3Little^1Kal,-2,34,43,44%,77,2023/04/17
2270,838,,KissMyGoat,+2,42,70,38%,112,2023/04/16
2271,838,,lesgraphistes11,-3,11,14,44%,25,2023/03/27
2272,838,,伊利达雷,-1,6,11,35%,17,2023/04/17
2273,837,,GloriousCanaries,-1,34,43,44%,77,2023/04/09
2274,837,,Goregoroth,-1,15,17,47%,32,2023/04/16
2275,836,,Uxellodunon,-1,7,18,28%,25,2023/04/17
2276,836,,[iur]Wipi,+1,4,8,33%,12,2023/03/21
2277,834,,Draggoras,-3,5,12,29%,17,2023/04/10
2278,834,,LouLou,-1,4,7,36%,11,2023/04/16
2279,834,,ＸＬＥＧＩＯ Artaserse ITA,-1,5,10,33%,15,2023/03/22
2280,834,,xwing57,-1,12,19,39%,31,2023/04/16
2281,834,,Banko,-3,20,23,47%,43,2023/04/02
2282,833,,AJEWISHBATTLEFROG,-1,5,9,36%,14,2023/04/15
2283,833,,St. Pete 2.0,-3,116,139,45%,255,2023/04/11
2284,833,,soldierforwar,+1,9,21,30%,30,2023/04/18
2285,833,,Bearly,-3,3,9,25%,12,2023/04/06
2286,832,,Columbus,-1,4,10,29%,14,2023/04/17
2287,832,,McRavage72,-1,11,16,41%,27,2023/04/17
2288,832,,diango40,-1,21,27,44%,48,2023/04/15
2289,832,,Erni,-4,3,7,30%,10,2023/03/21
2290,832,,TheUndeadNinjax,-1,4,12,25%,16,2023/04/16
2291,832,,achilleus18,+1,26,42,38%,68,2023/04/16
2292,832,,李贝留斯,-1,3,8,27%,11,2023/04/15
2293,831,,Dream Mariner,+1,5,10,33%,15,2023/04/06
2294,831,,Sebastian,-3,26,32,45%,58,2023/04/10
2295,831,,CN丶笙,-2,5,11,31%,16,2023/04/02
2296,831,,GerFuscher,+2,7,11,39%,18,2023/04/14
2297,831,,väderstad,-3,4,11,27%,15,2023/04/17
2298,830,,Lampealuile,-3,15,20,43%,35,2023/04/16
2299,830,,Gilhooley,+4,10,12,45%,22,2023/03/23
2300,830,,Mr.CrazyPerson,-1,28,42,40%,70,2023/04/11
2301,830,,Widgie,+1,2,8,20%,10,2023/04/16
2302,829,,Magicole,+1,11,16,41%,27,2023/04/12
2303,829,,sunny_yeung,-1,4,10,29%,14,2023/04/01
2304,829,,Margo,-2,5,10,33%,15,2023/03/25
2305,828,,Atomic Floyd,-3,3,8,27%,11,2023/03/25
2306,828,,ttvarlequin,-1,4,8,33%,12,2023/03/30
2307,828,,notcoffee,-4,9,15,38%,24,2023/04/05
2308,828,,Roiber,-1,11,17,39%,28,2023/04/07
2309,828,,快看有巨雕,+1,5,10,33%,15,2023/04/17
2310,827,,wckgg_87429656,-2,14,24,37%,38,2023/04/08
2311,827,,lipengzhang66,-3,4,12,25%,16,2023/04/05
2312,827,,ATROSERIP,+2,4,8,33%,12,2023/04/17
2313,827,,Eastone,-3,11,19,37%,30,2023/03/26
2314,827,,Kuno,-1,6,11,35%,17,2023/04/15
2315,827,,snowmonster,-6,4,10,29%,14,2023/03/26
2316,826,,1429214692,-1,14,17,45%,31,2023/04/12
2317,826,,Draco,+1,8,14,36%,22,2023/03/31
2318,826,,py931716344,-6,3,8,27%,11,2023/04/09
2319,825,,Suppomann,-2,63,71,47%,134,2023/04/10
2320,824,,guaps,-2,4,8,33%,12,2023/04/04
2321,824,,Strauß,-2,15,22,41%,37,2023/04/16
2322,824,,Herr Crit-ler,-3,16,20,44%,36,2023/04/03
2323,823,,beswick_5,+1,7,13,35%,20,2023/04/16
2324,823,,Flanders,-10,3,10,23%,13,2023/04/08
2325,823,,HostileCamper,-6,6,12,33%,18,2023/03/26
2326,822,,Deception,-2,3,7,30%,10,2023/04/07
2327,822,,Hauptman80,-1,110,137,45%,247,2023/04/17
2328,822,,kqperformingkq,+2,10,16,38%,26,2023/04/14
2329,822,,BRIGEI,-1,29,41,41%,70,2023/04/13
2330,822,,tutancamon84,-1,6,12,33%,18,2023/03/29
2331,822,,whothefock,+2,22,34,39%,56,2023/04/05
2332,822,,maxblackdog,-2,3,7,30%,10,2023/04/03
2333,822,,Friedrich der Große,-2,7,15,32%,22,2023/04/15
2334,821,,Broski,-1,3,10,23%,13,2023/04/06
2335,821,,Commander KM,-4,6,13,32%,19,2023/04/02
2336,821,,nonaino,-3,3,9,25%,12,2023/04/11
2337,821,,JackOfAll,-1,4,9,31%,13,2023/04/10
2338,819,,Jack Cruz,-1,20,37,35%,57,2023/04/12
2339,819,,Moeller,-1,10,18,36%,28,2023/04/17
2340,819,,304532544,-4,11,20,35%,31,2023/04/03
2341,818,,[NFB] Donkey,-1,3,8,27%,11,2023/03/27
2342,818,,Daniel the Maniel,-2,16,29,36%,45,2023/04/06
2343,817,,dalmatica,-2,4,9,31%,13,2023/04/17
2344,817,,stranger陌路,-1,5,12,29%,17,2023/04/12
2345,817,,Sev,+2,4,9,31%,13,2023/04/13
2346,817,,Jean Guile,-1,7,14,33%,21,2023/04/16
2347,816,,Ptr,+2,4,10,29%,14,2023/04/07
2348,816,,TP6,+1,5,10,33%,15,2023/04/07
2349,816,,windonet,+1,38,43,47%,81,2023/04/16
2350,816,,Major Liability,+1,13,22,37%,35,2023/04/04
2351,816,,Yupi,-1,26,34,43%,60,2023/04/17
2352,815,,24,-2,27,45,38%,72,2023/04/17
2353,815,,Krang,+1,8,14,36%,22,2023/03/31
2354,815,,clero,-3,6,12,33%,18,2023/04/08
2355,814,,donald_from_duckburg,-3,5,13,28%,18,2023/04/14
2356,814,,LORDTYRANNO,-1,14,22,39%,36,2023/04/17
2357,814,,St€\/-M@$t€r,-3,10,21,32%,31,2023/04/06
2358,813,,幻影刺客,-3,3,8,27%,11,2023/04/15
2359,812,,ColFri,+1,24,39,38%,63,2023/04/10
2360,812,,michael_airforce,-2,6,13,32%,19,2023/04/01
2361,811,,MatriX!.progamer,-2,11,15,42%,26,2023/03/29
2362,811,,󠁳⁧🥴,-1,15,18,45%,33,2023/03/27
2363,810,,pilchmennel,-5,5,14,26%,19,2023/04/15
2364,809,,Mysticassbreaker,-5,7,15,32%,22,2023/03/30
2365,809,,jamesbreean,-2,5,15,25%,20,2023/04/18
2366,808,,MIDO,-2,22,31,42%,53,2023/03/30
2367,808,,batur9323,-3,32,43,43%,75,2023/04/17
2368,807,,ottomanslap,+2,5,9,36%,14,2023/03/24
2369,807,,2easy2kill,+1,61,76,45%,137,2023/04/12
2370,806,,Nachtgespenst,+3,9,13,41%,22,2023/04/16
2371,806,,stephane.trelat,+1,1,9,10%,10,2023/04/12
2372,806,,mikkonen73,-1,3,8,27%,11,2023/04/08
2373,805,,Phönix SL,-3,5,11,31%,16,2023/04/16
2374,805,,Struppe,-5,3,9,25%,12,2023/04/17
2375,804,,MZ599,-4,7,18,28%,25,2023/03/25
2376,804,,FrostNuke,-4,3,9,25%,12,2023/04/02
2377,804,,General George,+2,4,9,31%,13,2023/04/06
2378,804,,MANSERVICE,+1,33,44,43%,77,2023/03/28
2379,803,,Skenssy,-1,12,19,39%,31,2023/03/30
2380,803,,Terror|Riff,-1,26,31,46%,57,2023/04/08
2381,803,,xanto,+3,14,26,35%,40,2023/04/10
2382,802,,D!A5,-5,3,8,27%,11,2023/03/31
2383,801,,Imam lud da sam papir™,-4,46,63,42%,109,2023/04/15
2384,801,,airwolf_staubsauger9000,-1,6,12,33%,18,2023/04/02
2385,800,,SigmaVulcan,-4,4,11,27%,15,2023/04/10
2386,800,,Ericese,-1,5,13,28%,18,2023/04/15
2387,798,,[YHG]TLK,+1,4,11,27%,15,2023/04/09
2388,798,,Taterbait,-5,16,26,38%,42,2023/04/05
2389,798,,Brother,+2,40,48,45%,88,2023/04/01
2390,797,,SU Mopsi,-2,6,14,30%,20,2023/04/09
2391,797,,btbuk1,+1,11,18,38%,29,2023/04/16
2392,796,,kev1287,-3,15,24,38%,39,2023/04/02
2393,796,,Deadrabbit,+3,45,60,43%,105,2023/04/15
2394,796,,dERzwERgvOmbERg,-2,48,71,40%,119,2023/04/18
2395,796,,不关橙猫猫的事,-2,25,43,37%,68,2023/04/16
2396,796,,Allawenchen,-2,16,28,36%,44,2023/04/11
2397,795,,ALEXI5000,-2,12,21,36%,33,2023/04/12
2398,794,,[R.A.F]-A.Baader,-3,10,22,31%,32,2023/03/21
2399,794,,Heisenberg,-4,6,13,32%,19,2023/04/16
2400,794,,ANDOGNNI,+2,24,40,38%,64,2023/03/31
2401,793,,Wolfstorm,-1,5,12,29%,17,2023/04/10
2402,793,,holy_kiwi,+1,3,10,23%,13,2023/04/16
2403,793,,314193543,+2,6,11,35%,17,2023/04/16
2404,792,,Volksgrenadier,+2,14,23,38%,37,2023/04/16
2405,791,,SOL,-2,15,26,37%,41,2023/04/08
2406,791,,Vexmeister,-1,3,8,27%,11,2023/04/05
2407,790,,LO-HAJ,-4,3,10,23%,13,2023/03/26
2408,790,,Stark,+2,5,14,26%,19,2023/04/13
2409,790,,Patriot_one,+1,30,38,44%,68,2023/04/08
2410,789,,看看你过的什么日子,-3,2,10,17%,12,2023/04/05
2411,789,,Zahzul,-3,3,10,23%,13,2023/04/16
2412,787,,mclauer,-5,3,11,21%,14,2023/03/31
2413,786,,Erich von Manstein,-1,10,22,31%,32,2023/04/15
2414,786,,Necrophobis,+1,3,9,25%,12,2023/04/10
2415,785,,[S.A.D] arckange,-1,21,32,40%,53,2023/03/24
2416,785,,CatalanBaris,+2,9,17,35%,26,2023/04/02
2417,784,,Stuka_Ju87,-8,7,16,30%,23,2023/04/06
2418,783,,VenomusV,-1,5,11,31%,16,2023/04/14
2419,783,,bl4ckjack,+1,2,8,20%,10,2023/04/02
2420,783,,General Mills,-3,8,17,32%,25,2023/04/17
2421,782,,HawkNoire,-2,4,9,31%,13,2023/03/29
2422,782,,Markus,+2,15,31,33%,46,2023/04/17
2423,782,,caxulito,+1,20,39,34%,59,2023/04/17
2424,781,,마딕(madick),-3,4,11,27%,15,2023/04/11
2425,780,,Jakub,-3,10,16,38%,26,2023/04/06
2426,780,,murlocmarine,+2,9,18,33%,27,2023/04/14
2427,779,,Techno_Tapas_303,-3,5,14,26%,19,2023/04/18
2428,779,,DraftDodger,-1,56,64,47%,120,2023/03/30
2429,778,,Fragm3nt,-2,7,13,35%,20,2023/03/24
2430,777,,Schmedium Toaster,-4,5,13,28%,18,2023/04/01
2431,776,,Mountainman,-1,35,56,38%,91,2023/04/11
2432,776,,Goulaschkanone,-1,29,38,43%,67,2023/04/13
2433,776,,Afrikakorps,-4,4,12,25%,16,2023/03/25
2434,775,,Wu Wei,-1,7,18,28%,25,2023/04/06
2435,774,,Gordon Ramsme,-3,4,11,27%,15,2023/04/17
2436,774,,Mega_Matt,+3,17,29,37%,46,2023/04/14
2437,774,,Andrew Tate,-3,3,11,21%,14,2023/04/15
2438,774,,Eisenhorn,-1,5,11,31%,16,2023/03/27
2439,774,,Robin son,-3,2,12,14%,14,2023/04/06
2440,774,,930328284,-1,14,26,35%,40,2023/04/10
2441,773,,VANITAxxxxx567,+2,8,14,36%,22,2023/04/18
2442,772,,kaczq4,-3,6,15,29%,21,2023/04/16
2443,771,,JP,-2,4,13,24%,17,2023/04/11
2444,770,,Abubakar Shekau,-1,43,66,39%,109,2023/04/12
2445,769,,$zczuto,-1,4,9,31%,13,2023/04/17
2446,767,,moustachemanu,-1,7,14,33%,21,2023/04/17
2447,767,,HansGutAryan,-1,12,19,39%,31,2023/03/29
2448,766,,profweetard,+3,14,24,37%,38,2023/04/01
2449,766,,craps,-4,8,20,29%,28,2023/03/26
2450,766,,Ultraprimat,-4,8,19,30%,27,2023/04/15
2451,766,,Yellen,-2,41,59,41%,100,2023/04/12
2452,762,,19barbar86,+2,60,78,43%,138,2023/04/16
2453,756,,marijuana,-5,5,14,26%,19,2023/04/08
2454,755,,johannes95,-4,3,11,21%,14,2023/03/26
2455,755,,GeneralTso,-8,3,12,20%,15,2023/04/17
2456,755,,Killercrab1065,-1,5,13,28%,18,2023/04/09
2457,753,,Fredo,-5,4,11,27%,15,2023/03/31
2458,752,,educastillospain,+1,6,15,29%,21,2023/04/07
2459,752,,不浪漫罪名,-5,4,13,24%,17,2023/04/14
2460,752,,echeve.santi,-4,14,22,39%,36,2023/04/07
2461,750,,Grover the Trash Hermit,-2,6,13,32%,19,2023/04/13
2462,750,,donot85,+2,8,16,33%,24,2023/04/12
2463,749,,Gnasken,-4,11,20,35%,31,2023/04/13
2464,749,,JBsarg3,-6,2,8,20%,10,2023/04/06
2465,749,,Shafty,-6,14,30,32%,44,2023/04/14
2466,747,,MrJossiboy,-3,2,9,18%,11,2023/03/23
2467,747,,jcanary54,-7,3,10,23%,13,2023/04/12
2468,747,,Krzysiek_PL,-10,0,10,0%,10,2023/03/26
2469,747,,wayneo0,-9,6,22,21%,28,2023/04/07
2470,746,,USSR,-2,8,16,33%,24,2023/03/22
2471,745,,Dethburger,+1,13,29,31%,42,2023/04/16
2472,744,,N8an,-1,2,9,18%,11,2023/03/21
2473,744,,Nascour90,+1,1,9,10%,10,2023/04/12
2474,742,,FuzzyDunlop81,-3,1,9,10%,10,2023/03/31
2475,741,,AtlasRedux,+1,17,37,31%,54,2023/03/28
2476,741,,GENERAL BALLSLAPPER,-1,5,14,26%,19,2023/04/15
2477,740,,iscl21,-2,3,12,20%,15,2023/04/17
2478,738,,553148533,+1,1,11,8%,12,2023/03/21
2479,737,,Junker,+1,2,8,20%,10,2023/03/22
2480,737,,Bob8401318,-3,2,9,18%,11,2023/03/30
2481,737,,Gbr95,-5,2,10,17%,12,2023/03/28
2482,734,,gisak,+1,6,19,24%,25,2023/04/08
2483,732,,< blank >,-2,16,30,35%,46,2023/04/13
2484,732,,JKimmawasp,-4,3,11,21%,14,2023/04/09
2485,732,,迷失之奥拉夫,-4,1,9,10%,10,2023/03/29
2486,731,,1271031010,-2,2,12,14%,14,2023/04/02
2487,731,,Jayce The Doe,-5,24,50,32%,74,2023/04/14
2488,730,,Eat_Sleep_Dave_Repeat,+2,3,10,23%,13,2023/04/11
2489,730,,BLUE Guy,-4,7,16,30%,23,2023/04/05
2490,730,,CTG｜SS,-5,3,10,23%,13,2023/03/30
2491,729,,White,+1,23,45,34%,68,2023/04/14
2492,728,,Allied Mastercomputer,-1,6,17,26%,23,2023/04/03
2493,727,,Bradbury,-3,16,38,30%,54,2023/04/06
2494,726,,Komix,-1,11,25,31%,36,2023/03/21
2495,726,,Jonesman265,+1,1,9,10%,10,2023/04/04
2496,724,,Blondin,-6,9,21,30%,30,2023/04/17
2497,723,,Herzog Otto,-5,3,10,23%,13,2023/04/09
2498,722,,Junky147,-8,1,11,8%,12,2023/03/29
2499,722,,Bourrafond,-4,3,9,25%,12,2023/04/15
2500,721,,I Am Ed,-6,1,9,10%,10,2023/04/14
2501,721,,I Am Ed,-6,1,9,10%,10,2023/04/14
2502,720,,giluma404,-3,2,9,18%,11,2023/04/10
2503,720,,Jul,-6,3,14,18%,17,2023/04/08
2504,717,,klopinsel,+1,11,24,31%,35,2023/04/14
2505,716,,3che,-4,5,16,24%,21,2023/04/17
2506,715,,kundernietsvan,-7,1,9,10%,10,2023/04/16
2507,715,,ScottNoM8s,-10,1,10,9%,11,2023/04/08
2508,715,,Legba,-2,8,18,31%,26,2023/04/14
2509,715,,Samako,-1,3,13,19%,16,2023/04/15
2510,714,,ferdinand,-6,2,12,14%,14,2023/04/08
2511,714,,obaum69,-3,10,22,31%,32,2023/04/16
2512,713,,christus99,-3,6,20,23%,26,2023/04/16
2513,711,,Cpt.Dankey,-5,1,11,8%,12,2023/03/29
2514,709,,matt197,+1,5,18,22%,23,2023/04/16
2515,708,,m0t0r,-2,11,18,38%,29,2023/03/26
2516,708,,Beetle,-5,7,23,23%,30,2023/04/17
2517,704,,Veeh Youtube,-3,18,43,30%,61,2023/04/17
2518,704,,Knigge,-1,43,73,37%,116,2023/04/17
2519,701,,nerbul,+1,18,38,32%,56,2023/04/13
2520,695,,ojeda622,+1,3,13,19%,16,2023/04/15
2521,692,,freeclimber,-3,8,19,30%,27,2023/04/15
2522,691,,NEILO-LTC,+1,16,24,40%,40,2023/03/26
2523,686,,OverEasy13,-6,1,9,10%,10,2023/04/14
2524,685,,Maangas,-5,3,11,21%,14,2023/04/12
2525,685,,HerbthePerv,+1,9,20,31%,29,2023/04/17
2526,685,,KlerosTNT,-9,1,9,10%,10,2023/04/01
2527,684,,Selfishbanshee,-1,5,15,25%,20,2023/04/11
2528,684,,Maleven,-2,16,41,28%,57,2023/04/17
2529,683,,Miku,+1,31,62,33%,93,2023/04/16
2530,680,,RAF FR,-9,7,20,26%,27,2023/04/14
2531,679,,Copaex,-4,2,16,11%,18,2023/04/07
2532,678,,Xav,+2,36,93,28%,129,2023/04/08
2533,674,,dieselcasa,-6,1,9,10%,10,2023/04/15
2534,673,,Cosk,-1,8,24,25%,32,2023/03/31
2535,671,,PlayofAthens,-6,9,26,26%,35,2023/03/29
2536,669,,W3rw0lf,-5,21,70,23%,91,2023/04/18
2537,664,,[MG] BulletDispenser,-8,25,52,32%,77,2023/03/21
2538,663,,Laredo,-4,5,20,20%,25,2023/04/08
2539,663,,A.Brent,-10,0,10,0%,10,2023/04/10
2540,659,,xXPINKxxFLOYDXx,-5,1,12,8%,13,2023/03/25
2541,658,,LoneRaider,-4,11,29,28%,40,2023/04/10
2542,656,,lovas47,-3,4,16,20%,20,2023/04/17
2543,655,,dennis.sturm87,+2,6,21,22%,27,2023/04/15
2544,650,,iBucNasty,-2,5,25,17%,30,2023/04/13
2545,650,,WALDEMAR☠,-4,10,36,22%,46,2023/04/16
2546,648,,Spontaneous,-4,3,18,14%,21,2023/04/16
2547,646,,Whykiki FR,-9,1,11,8%,12,2023/03/25
2548,640,,rabbidrascal,-2,2,18,10%,20,2023/04/17
2549,637,,j18el,-6,73,122,37%,195,2023/04/16
2550,634,,Schnipster1,-4,4,18,18%,22,2023/04/12
2551,634,,Vito Scaletta,-10,11,38,22%,49,2023/04/13
2552,633,,Kurowasun,-11,0,11,0%,11,2023/03/29
2553,632,,Jub,-1,6,16,27%,22,2023/04/17
2554,632,,christianln1,-9,9,33,21%,42,2023/04/16
2555,630,,Feindflug,-10,7,25,22%,32,2023/03/27
2556,629,,Wrujo,-3,14,51,22%,65,2023/04/17
2557,626,,{ ลูฟี่ }2017,-3,7,35,17%,42,2023/04/07
2558,613,,Karstenbrandt,-7,2,15,12%,17,2023/04/10
2559,610,,derrick_dutchy,+1,10,30,25%,40,2023/04/10
2560,610,,Rurin,-3,8,28,22%,36,2023/03/23
2561,607,,Clopticon,-8,50,93,35%,143,2023/04/15
2562,596,,MarRei0407,-12,5,26,16%,31,2023/04/02
2563,596,,MENTALLY ILL LIL SQUARE BUB,-5,5,22,19%,27,2023/04/11
2564,575,,Mad Duck,-16,1,21,5%,22,2023/04/08
2565,573,,Skripos,-3,9,35,20%,44,2023/04/04
2566,564,,lelo.10452,-9,1,17,6%,18,2023/03/23
2567,562,,守猎者01,-18,0,18,0%,18,2023/04/17
2568,561,,爱念痛,-4,21,78,21%,99,2023/04/10
2569,555,,yoshibo,-3,24,130,16%,154,2023/04/14
2570,543,,pabloocontreras13,-21,2,27,7%,29,2023/04/09
2571,540,,SirOwnsAlot,-1,19,85,18%,104,2023/04/09
2572,537,,牛人,-6,4,22,15%,26,2023/04/15
2573,531,,helene8,-19,0,19,0%,19,2023/04/08
